datetime,小汽车数量,自行车数量,公交车数量,卡车数量,总车辆数量,交通状况,hour,weekday,is_weekend
2021-07-10 00:00:00,13,2,2,24,41,normal,0,5,0
2021-07-10 00:15:00,14,1,1,36,52,normal,0,5,0
2021-07-10 00:30:00,10,2,2,32,46,normal,0,5,0
2021-07-10 00:45:00,10,2,2,36,50,normal,0,5,0
2021-07-10 01:00:00,11,2,1,34,48,normal,1,5,0
2021-07-10 01:15:00,15,1,1,39,56,normal,1,5,0
2021-07-10 01:30:00,14,2,2,27,45,normal,1,5,0
2021-07-10 01:45:00,13,2,1,20,36,normal,1,5,0
2021-07-10 02:00:00,7,0,0,26,33,normal,2,5,0
2021-07-10 02:15:00,13,0,0,34,47,normal,2,5,0
2021-07-10 02:30:00,15,2,0,38,55,normal,2,5,0
2021-07-10 02:45:00,5,2,0,37,44,normal,2,5,0
2021-07-10 03:00:00,9,1,0,34,44,normal,3,5,0
2021-07-10 03:15:00,8,0,2,35,45,normal,3,5,0
2021-07-10 03:30:00,7,0,0,34,41,normal,3,5,0
2021-07-10 03:45:00,10,1,2,38,51,normal,3,5,0
2021-07-10 04:00:00,82,7,3,10,102,low,4,5,0
2021-07-10 04:15:00,71,3,0,30,104,normal,4,5,0
2021-07-10 04:30:00,89,10,2,10,111,low,4,5,0
2021-07-10 04:45:00,77,3,0,18,98,low,4,5,0
2021-07-10 05:00:00,90,2,0,22,114,normal,5,5,0
2021-07-10 05:15:00,84,1,7,23,115,normal,5,5,0
2021-07-10 05:30:00,88,8,6,10,112,normal,5,5,0
2021-07-10 05:45:00,97,27,15,8,147,normal,5,5,0
2021-07-10 06:00:00,107,10,24,11,152,normal,6,5,0
2021-07-10 06:15:00,82,26,11,5,124,normal,6,5,0
2021-07-10 06:30:00,93,16,24,10,143,normal,6,5,0
2021-07-10 06:45:00,128,18,14,6,166,normal,6,5,0
2021-07-10 07:00:00,110,19,12,14,155,normal,7,5,0
2021-07-10 07:15:00,122,13,10,5,150,normal,7,5,0
2021-07-10 07:30:00,92,14,16,12,134,normal,7,5,0
2021-07-10 07:45:00,143,30,17,12,202,heavy,7,5,0
2021-07-10 08:00:00,134,18,21,11,184,heavy,8,5,0
2021-07-10 08:15:00,134,30,15,14,193,heavy,8,5,0
2021-07-10 08:30:00,119,13,14,13,159,normal,8,5,0
2021-07-10 08:45:00,139,12,22,13,186,heavy,8,5,0
2021-07-10 09:00:00,73,9,14,17,113,normal,9,5,0
2021-07-10 09:15:00,33,12,9,6,60,low,9,5,0
2021-07-10 09:30:00,69,9,26,9,113,high,9,5,0
2021-07-10 09:45:00,69,12,10,5,96,low,9,5,0
2021-07-10 10:00:00,55,11,9,17,92,low,10,5,0
2021-07-10 10:15:00,32,7,27,12,78,normal,10,5,0
2021-07-10 10:30:00,53,13,7,5,78,low,10,5,0
2021-07-10 10:45:00,34,10,9,35,88,normal,10,5,0
2021-07-10 11:00:00,32,10,10,26,78,normal,11,5,0
2021-07-10 11:15:00,47,10,5,25,87,normal,11,5,0
2021-07-10 11:30:00,28,0,5,29,62,normal,11,5,0
2021-07-10 11:45:00,35,7,13,34,89,normal,11,5,0
2021-07-10 12:00:00,38,10,8,31,87,normal,12,5,0
2021-07-10 12:15:00,32,3,12,35,82,normal,12,5,0
2021-07-10 12:30:00,54,5,12,29,100,normal,12,5,0
2021-07-10 12:45:00,52,2,12,29,95,normal,12,5,0
2021-07-10 13:00:00,68,19,18,30,135,normal,13,5,0
2021-07-10 13:15:00,73,15,3,17,108,low,13,5,0
2021-07-10 13:30:00,21,18,18,23,80,normal,13,5,0
2021-07-10 13:45:00,63,11,16,11,101,normal,13,5,0
2021-07-10 14:00:00,7,17,20,18,62,normal,14,5,0
2021-07-10 14:15:00,76,15,32,17,140,high,14,5,0
2021-07-10 14:30:00,59,14,18,28,119,normal,14,5,0
2021-07-10 14:45:00,90,9,3,14,116,normal,14,5,0
2021-07-10 15:00:00,5,13,4,20,42,normal,15,5,0
2021-07-10 15:15:00,33,18,22,23,96,normal,15,5,0
2021-07-10 15:30:00,39,19,13,23,94,normal,15,5,0
2021-07-10 15:45:00,150,21,10,14,195,heavy,15,5,0
2021-07-10 16:00:00,126,27,40,19,212,heavy,16,5,0
2021-07-10 16:15:00,144,7,35,17,203,heavy,16,5,0
2021-07-10 16:30:00,145,13,12,18,188,heavy,16,5,0
2021-07-10 16:45:00,121,29,27,15,192,heavy,16,5,0
2021-07-10 17:00:00,150,21,37,19,227,heavy,17,5,0
2021-07-10 17:15:00,122,8,10,11,151,normal,17,5,0
2021-07-10 17:30:00,129,20,35,18,202,heavy,17,5,0
2021-07-10 17:45:00,114,7,39,19,179,heavy,17,5,0
2021-07-10 18:00:00,109,10,26,17,162,high,18,5,0
2021-07-10 18:15:00,101,22,24,18,165,normal,18,5,0
2021-07-10 18:30:00,91,13,8,12,124,normal,18,5,0
2021-07-10 18:45:00,90,17,10,11,128,normal,18,5,0
2021-07-10 19:00:00,107,2,15,35,159,high,19,5,0
2021-07-10 19:15:00,66,7,5,22,100,normal,19,5,0
2021-07-10 19:30:00,98,5,7,30,140,normal,19,5,0
2021-07-10 19:45:00,91,10,17,28,146,normal,19,5,0
2021-07-10 20:00:00,82,4,9,20,115,normal,20,5,0
2021-07-10 20:15:00,65,10,19,18,112,normal,20,5,0
2021-07-10 20:30:00,54,3,20,15,92,normal,20,5,0
2021-07-10 20:45:00,78,6,16,35,135,high,20,5,0
2021-07-10 21:00:00,70,20,10,33,133,high,21,5,0
2021-07-10 21:15:00,90,9,11,11,121,normal,21,5,0
2021-07-10 21:30:00,96,0,19,23,138,normal,21,5,0
2021-07-10 21:45:00,14,1,0,27,42,normal,21,5,0
2021-07-10 22:00:00,7,1,0,36,44,normal,22,5,0
2021-07-10 22:15:00,9,0,2,35,46,normal,22,5,0
2021-07-10 22:30:00,7,0,0,34,41,normal,22,5,0
2021-07-10 22:45:00,11,0,1,33,45,normal,22,5,0
2021-07-10 23:00:00,11,2,2,40,55,normal,23,5,0
2021-07-10 23:15:00,11,1,0,31,43,normal,23,5,0
2021-07-10 23:30:00,9,2,1,20,32,normal,23,5,0
2021-07-10 23:45:00,8,1,2,31,42,normal,23,5,0
2021-07-11 00:00:00,9,1,2,29,41,normal,0,6,1
2021-07-11 00:15:00,12,2,1,32,47,normal,0,6,1
2021-07-11 00:30:00,11,2,1,33,47,normal,0,6,1
2021-07-11 00:45:00,7,0,0,29,36,normal,0,6,1
2021-07-11 01:00:00,5,1,2,21,29,normal,1,6,1
2021-07-11 01:15:00,13,1,2,20,36,normal,1,6,1
2021-07-11 01:30:00,7,1,0,40,48,normal,1,6,1
2021-07-11 01:45:00,13,2,2,30,47,normal,1,6,1
2021-07-11 02:00:00,10,0,2,35,47,normal,2,6,1
2021-07-11 02:15:00,15,2,2,32,51,normal,2,6,1
2021-07-11 02:30:00,8,2,2,26,38,normal,2,6,1
2021-07-11 02:45:00,11,0,0,28,39,normal,2,6,1
2021-07-11 03:00:00,7,0,1,36,44,normal,3,6,1
2021-07-11 03:15:00,8,0,1,32,41,normal,3,6,1
2021-07-11 03:30:00,15,1,0,35,51,normal,3,6,1
2021-07-11 03:45:00,9,1,0,33,43,normal,3,6,1
2021-07-11 04:00:00,72,7,2,14,95,low,4,6,1
2021-07-11 04:15:00,64,7,7,20,98,normal,4,6,1
2021-07-11 04:30:00,85,8,5,14,112,normal,4,6,1
2021-07-11 04:45:00,73,6,6,15,100,low,4,6,1
2021-07-11 05:00:00,57,0,0,15,72,low,5,6,1
2021-07-11 05:15:00,81,4,4,24,113,normal,5,6,1
2021-07-11 05:30:00,54,6,3,18,81,low,5,6,1
2021-07-11 05:45:00,97,22,23,12,154,normal,5,6,1
2021-07-11 06:00:00,109,10,14,13,146,normal,6,6,1
2021-07-11 06:15:00,102,23,23,11,159,normal,6,6,1
2021-07-11 06:30:00,135,13,18,6,172,heavy,6,6,1
2021-07-11 06:45:00,105,12,13,9,139,normal,6,6,1
2021-07-11 07:00:00,90,17,19,8,134,normal,7,6,1
2021-07-11 07:15:00,104,14,19,7,144,normal,7,6,1
2021-07-11 07:30:00,134,20,24,8,186,heavy,7,6,1
2021-07-11 07:45:00,120,26,17,8,171,heavy,7,6,1
2021-07-11 08:00:00,142,19,16,5,182,heavy,8,6,1
2021-07-11 08:15:00,121,28,20,15,184,heavy,8,6,1
2021-07-11 08:30:00,85,26,17,9,137,normal,8,6,1
2021-07-11 08:45:00,140,15,14,12,181,heavy,8,6,1
2021-07-11 09:00:00,68,12,29,12,121,high,9,6,1
2021-07-11 09:15:00,56,7,14,15,92,low,9,6,1
2021-07-11 09:30:00,33,14,12,19,78,normal,9,6,1
2021-07-11 09:45:00,61,9,18,6,94,normal,9,6,1
2021-07-11 10:00:00,36,10,24,14,84,normal,10,6,1
2021-07-11 10:15:00,57,13,22,19,111,normal,10,6,1
2021-07-11 10:30:00,64,9,20,19,112,normal,10,6,1
2021-07-11 10:45:00,30,7,1,31,69,normal,10,6,1
2021-07-11 11:00:00,54,10,10,28,102,normal,11,6,1
2021-07-11 11:15:00,28,5,12,29,74,normal,11,6,1
2021-07-11 11:30:00,50,2,4,30,86,normal,11,6,1
2021-07-11 11:45:00,60,4,3,26,93,normal,11,6,1
2021-07-11 12:00:00,39,4,4,30,77,normal,12,6,1
2021-07-11 12:15:00,32,1,12,27,72,normal,12,6,1
2021-07-11 12:30:00,59,3,12,28,102,normal,12,6,1
2021-07-11 12:45:00,64,9,9,25,107,normal,12,6,1
2021-07-11 13:00:00,52,17,17,21,107,normal,13,6,1
2021-07-11 13:15:00,96,14,3,22,135,normal,13,6,1
2021-07-11 13:30:00,61,8,21,24,114,normal,13,6,1
2021-07-11 13:45:00,100,7,11,22,140,normal,13,6,1
2021-07-11 14:00:00,6,8,32,24,70,normal,14,6,1
2021-07-11 14:15:00,88,14,32,26,160,high,14,6,1
2021-07-11 14:30:00,27,14,15,23,79,normal,14,6,1
2021-07-11 14:45:00,22,15,21,10,68,normal,14,6,1
2021-07-11 15:00:00,53,5,17,21,96,normal,15,6,1
2021-07-11 15:15:00,61,11,27,22,121,high,15,6,1
2021-07-11 15:30:00,74,13,5,26,118,normal,15,6,1
2021-07-11 15:45:00,121,7,16,20,164,normal,15,6,1
2021-07-11 16:00:00,110,9,37,13,169,heavy,16,6,1
2021-07-11 16:15:00,116,12,39,12,179,heavy,16,6,1
2021-07-11 16:30:00,100,27,39,13,179,heavy,16,6,1
2021-07-11 16:45:00,118,11,28,11,168,heavy,16,6,1
2021-07-11 17:00:00,137,14,13,13,177,heavy,17,6,1
2021-07-11 17:15:00,130,23,14,18,185,heavy,17,6,1
2021-07-11 17:30:00,146,13,10,18,187,heavy,17,6,1
2021-07-11 17:45:00,114,23,19,11,167,normal,17,6,1
2021-07-11 18:00:00,104,18,15,15,152,normal,18,6,1
2021-07-11 18:15:00,114,24,31,10,179,heavy,18,6,1
2021-07-11 18:30:00,90,0,18,11,119,normal,18,6,1
2021-07-11 18:45:00,95,2,9,15,121,normal,18,6,1
2021-07-11 19:00:00,60,4,7,28,99,normal,19,6,1
2021-07-11 19:15:00,72,1,9,32,114,high,19,6,1
2021-07-11 19:30:00,92,20,11,31,154,high,19,6,1
2021-07-11 19:45:00,70,18,9,23,120,normal,19,6,1
2021-07-11 20:00:00,97,8,17,10,132,normal,20,6,1
2021-07-11 20:15:00,72,11,5,24,112,normal,20,6,1
2021-07-11 20:30:00,60,12,20,28,120,normal,20,6,1
2021-07-11 20:45:00,62,7,7,13,89,low,20,6,1
2021-07-11 21:00:00,79,19,13,17,128,normal,21,6,1
2021-07-11 21:15:00,92,9,15,19,135,normal,21,6,1
2021-07-11 21:30:00,62,1,5,10,78,low,21,6,1
2021-07-11 21:45:00,13,0,1,39,53,normal,21,6,1
2021-07-11 22:00:00,15,2,1,24,42,normal,22,6,1
2021-07-11 22:15:00,12,2,2,22,38,normal,22,6,1
2021-07-11 22:30:00,5,0,0,36,41,normal,22,6,1
2021-07-11 22:45:00,11,1,2,26,40,normal,22,6,1
2021-07-11 23:00:00,6,1,2,28,37,normal,23,6,1
2021-07-11 23:15:00,6,0,1,27,34,normal,23,6,1
2021-07-11 23:30:00,10,0,2,33,45,normal,23,6,1
2021-07-11 23:45:00,5,0,1,27,33,normal,23,6,1
2021-07-12 00:00:00,6,1,2,37,46,normal,0,0,0
2021-07-12 00:15:00,5,2,1,36,44,normal,0,0,0
2021-07-12 00:30:00,6,1,0,26,33,normal,0,0,0
2021-07-12 00:45:00,9,2,0,21,32,normal,0,0,0
2021-07-12 01:00:00,11,2,2,35,50,normal,1,0,0
2021-07-12 01:15:00,8,2,0,34,44,normal,1,0,0
2021-07-12 01:30:00,14,2,0,35,51,normal,1,0,0
2021-07-12 01:45:00,8,0,0,36,44,normal,1,0,0
2021-07-12 02:00:00,10,1,0,21,32,normal,2,0,0
2021-07-12 02:15:00,14,0,1,35,50,normal,2,0,0
2021-07-12 02:30:00,8,1,0,21,30,normal,2,0,0
2021-07-12 02:45:00,12,2,1,37,52,normal,2,0,0
2021-07-12 03:00:00,15,2,1,30,48,normal,3,0,0
2021-07-12 03:15:00,12,2,1,33,48,normal,3,0,0
2021-07-12 03:30:00,8,0,2,38,48,normal,3,0,0
2021-07-12 03:45:00,10,1,2,39,52,normal,3,0,0
2021-07-12 04:00:00,90,5,0,28,123,normal,4,0,0
2021-07-12 04:15:00,57,9,0,15,81,low,4,0,0
2021-07-12 04:30:00,61,5,0,11,77,low,4,0,0
2021-07-12 04:45:00,84,10,6,16,116,normal,4,0,0
2021-07-12 05:00:00,59,8,5,18,90,low,5,0,0
2021-07-12 05:15:00,64,5,3,27,99,normal,5,0,0
2021-07-12 05:30:00,72,3,5,10,90,low,5,0,0
2021-07-12 05:45:00,102,12,14,7,135,normal,5,0,0
2021-07-12 06:00:00,132,16,23,9,180,heavy,6,0,0
2021-07-12 06:15:00,114,11,25,7,157,normal,6,0,0
2021-07-12 06:30:00,117,18,22,12,169,heavy,6,0,0
2021-07-12 06:45:00,149,15,10,15,189,heavy,6,0,0
2021-07-12 07:00:00,103,29,12,6,150,normal,7,0,0
2021-07-12 07:15:00,81,30,16,5,132,normal,7,0,0
2021-07-12 07:30:00,140,14,12,12,178,heavy,7,0,0
2021-07-12 07:45:00,88,25,23,5,141,normal,7,0,0
2021-07-12 08:00:00,146,17,20,6,189,heavy,8,0,0
2021-07-12 08:15:00,148,16,25,6,195,heavy,8,0,0
2021-07-12 08:30:00,125,21,22,11,179,heavy,8,0,0
2021-07-12 08:45:00,88,30,23,5,146,normal,8,0,0
2021-07-12 09:00:00,67,14,24,19,124,normal,9,0,0
2021-07-12 09:15:00,56,12,30,16,114,high,9,0,0
2021-07-12 09:30:00,75,9,15,19,118,normal,9,0,0
2021-07-12 09:45:00,52,8,5,12,77,low,9,0,0
2021-07-12 10:00:00,40,9,25,12,86,normal,10,0,0
2021-07-12 10:15:00,46,7,30,13,96,normal,10,0,0
2021-07-12 10:30:00,76,6,8,14,104,low,10,0,0
2021-07-12 10:45:00,62,6,6,25,99,normal,10,0,0
2021-07-12 11:00:00,63,8,9,27,107,normal,11,0,0
2021-07-12 11:15:00,39,2,12,25,78,normal,11,0,0
2021-07-12 11:30:00,55,7,4,35,101,normal,11,0,0
2021-07-12 11:45:00,64,9,8,34,115,high,11,0,0
2021-07-12 12:00:00,56,1,5,27,89,normal,12,0,0
2021-07-12 12:15:00,43,3,4,35,85,normal,12,0,0
2021-07-12 12:30:00,52,0,3,30,85,normal,12,0,0
2021-07-12 12:45:00,25,7,4,33,69,normal,12,0,0
2021-07-12 13:00:00,47,13,0,18,78,low,13,0,0
2021-07-12 13:15:00,26,16,31,26,99,normal,13,0,0
2021-07-12 13:30:00,86,3,9,30,128,normal,13,0,0
2021-07-12 13:45:00,46,6,21,11,84,normal,13,0,0
2021-07-12 14:00:00,66,13,3,26,108,normal,14,0,0
2021-07-12 14:15:00,89,19,21,18,147,normal,14,0,0
2021-07-12 14:30:00,88,1,10,21,120,normal,14,0,0
2021-07-12 14:45:00,88,8,8,24,128,normal,14,0,0
2021-07-12 15:00:00,96,20,28,14,158,high,15,0,0
2021-07-12 15:15:00,70,1,20,16,107,normal,15,0,0
2021-07-12 15:30:00,79,3,14,22,118,normal,15,0,0
2021-07-12 15:45:00,133,6,21,15,175,heavy,15,0,0
2021-07-12 16:00:00,128,11,38,14,191,heavy,16,0,0
2021-07-12 16:15:00,123,27,34,13,197,heavy,16,0,0
2021-07-12 16:30:00,129,23,17,16,185,heavy,16,0,0
2021-07-12 16:45:00,104,22,40,11,177,heavy,16,0,0
2021-07-12 17:00:00,128,9,19,14,170,heavy,17,0,0
2021-07-12 17:15:00,130,10,38,11,189,heavy,17,0,0
2021-07-12 17:30:00,146,14,35,15,210,heavy,17,0,0
2021-07-12 17:45:00,120,22,32,17,191,heavy,17,0,0
2021-07-12 18:00:00,102,25,31,14,172,heavy,18,0,0
2021-07-12 18:15:00,116,11,18,18,163,normal,18,0,0
2021-07-12 18:30:00,83,19,15,22,139,normal,18,0,0
2021-07-12 18:45:00,67,10,11,24,112,normal,18,0,0
2021-07-12 19:00:00,98,5,9,25,137,normal,19,0,0
2021-07-12 19:15:00,61,2,11,31,105,normal,19,0,0
2021-07-12 19:30:00,80,14,5,15,114,normal,19,0,0
2021-07-12 19:45:00,59,5,6,11,81,low,19,0,0
2021-07-12 20:00:00,68,14,20,10,112,normal,20,0,0
2021-07-12 20:15:00,84,15,12,16,127,normal,20,0,0
2021-07-12 20:30:00,67,19,16,17,119,normal,20,0,0
2021-07-12 20:45:00,53,14,19,33,119,high,20,0,0
2021-07-12 21:00:00,50,1,6,20,77,normal,21,0,0
2021-07-12 21:15:00,64,0,9,32,105,normal,21,0,0
2021-07-12 21:30:00,70,4,5,24,103,normal,21,0,0
2021-07-12 21:45:00,5,0,0,38,43,normal,21,0,0
2021-07-12 22:00:00,11,2,0,38,51,normal,22,0,0
2021-07-12 22:15:00,11,1,1,40,53,normal,22,0,0
2021-07-12 22:30:00,12,1,2,31,46,normal,22,0,0
2021-07-12 22:45:00,5,1,0,36,42,normal,22,0,0
2021-07-12 23:00:00,5,0,0,23,28,normal,23,0,0
2021-07-12 23:15:00,6,0,2,26,34,normal,23,0,0
2021-07-12 23:30:00,15,1,2,20,38,normal,23,0,0
2021-07-12 23:45:00,6,2,0,24,32,normal,23,0,0
2021-07-13 00:00:00,6,1,2,40,49,normal,0,1,0
2021-07-13 00:15:00,6,1,0,39,46,normal,0,1,0
2021-07-13 00:30:00,15,1,2,23,41,normal,0,1,0
2021-07-13 00:45:00,7,1,2,35,45,normal,0,1,0
2021-07-13 01:00:00,15,0,0,22,37,normal,1,1,0
2021-07-13 01:15:00,11,2,2,33,48,normal,1,1,0
2021-07-13 01:30:00,14,2,1,24,41,normal,1,1,0
2021-07-13 01:45:00,5,2,2,36,45,normal,1,1,0
2021-07-13 02:00:00,9,0,2,35,46,normal,2,1,0
2021-07-13 02:15:00,14,0,0,30,44,normal,2,1,0
2021-07-13 02:30:00,5,0,0,29,34,normal,2,1,0
2021-07-13 02:45:00,9,0,1,36,46,normal,2,1,0
2021-07-13 03:00:00,15,1,2,36,54,normal,3,1,0
2021-07-13 03:15:00,11,1,0,20,32,normal,3,1,0
2021-07-13 03:30:00,14,1,2,29,46,normal,3,1,0
2021-07-13 03:45:00,5,0,1,38,44,normal,3,1,0
2021-07-13 04:00:00,54,7,2,27,90,normal,4,1,0
2021-07-13 04:15:00,52,5,2,54,113,high,4,1,0
2021-07-13 04:30:00,64,7,3,59,133,high,4,1,0
2021-07-13 04:45:00,28,7,4,35,74,normal,4,1,0
2021-07-13 05:00:00,79,2,2,48,131,high,5,1,0
2021-07-13 05:15:00,58,0,3,35,96,normal,5,1,0
2021-07-13 05:30:00,43,4,0,48,95,normal,5,1,0
2021-07-13 05:45:00,72,5,3,57,137,high,5,1,0
2021-07-13 06:00:00,63,0,0,43,106,normal,6,1,0
2021-07-13 06:15:00,58,10,1,58,127,high,6,1,0
2021-07-13 06:30:00,25,2,3,26,56,normal,6,1,0
2021-07-13 06:45:00,26,6,2,56,90,normal,6,1,0
2021-07-13 07:00:00,53,5,5,25,88,normal,7,1,0
2021-07-13 07:15:00,34,6,1,34,75,normal,7,1,0
2021-07-13 07:30:00,27,3,5,53,88,normal,7,1,0
2021-07-13 07:45:00,77,0,3,44,124,high,7,1,0
2021-07-13 08:00:00,65,10,1,52,128,high,8,1,0
2021-07-13 08:15:00,65,6,3,55,129,high,8,1,0
2021-07-13 08:30:00,78,6,2,35,121,high,8,1,0
2021-07-13 08:45:00,36,6,5,57,104,normal,8,1,0
2021-07-13 09:00:00,144,42,11,7,204,heavy,9,1,0
2021-07-13 09:15:00,125,29,19,6,179,heavy,9,1,0
2021-07-13 09:30:00,114,50,6,8,178,heavy,9,1,0
2021-07-13 09:45:00,136,24,20,6,186,heavy,9,1,0
2021-07-13 10:00:00,114,37,19,7,177,heavy,10,1,0
2021-07-13 10:15:00,141,50,16,5,212,heavy,10,1,0
2021-07-13 10:30:00,117,50,20,10,197,heavy,10,1,0
2021-07-13 10:45:00,103,40,11,9,163,normal,10,1,0
2021-07-13 11:00:00,131,39,5,5,180,heavy,11,1,0
2021-07-13 11:15:00,119,22,6,8,155,normal,11,1,0
2021-07-13 11:30:00,104,35,19,9,167,normal,11,1,0
2021-07-13 11:45:00,146,24,13,6,189,heavy,11,1,0
2021-07-13 12:00:00,134,26,14,6,180,heavy,12,1,0
2021-07-13 12:15:00,111,46,19,8,184,heavy,12,1,0
2021-07-13 12:30:00,106,37,19,8,170,heavy,12,1,0
2021-07-13 12:45:00,128,36,12,9,185,heavy,12,1,0
2021-07-13 13:00:00,101,36,11,9,157,normal,13,1,0
2021-07-13 13:15:00,142,21,7,9,179,heavy,13,1,0
2021-07-13 13:30:00,124,21,10,5,160,normal,13,1,0
2021-07-13 13:45:00,103,22,20,7,152,normal,13,1,0
2021-07-13 14:00:00,139,47,7,8,201,heavy,14,1,0
2021-07-13 14:15:00,127,28,20,10,185,heavy,14,1,0
2021-07-13 14:30:00,126,39,13,7,185,heavy,14,1,0
2021-07-13 14:45:00,100,41,15,8,164,normal,14,1,0
2021-07-13 15:00:00,66,5,5,17,93,low,15,1,0
2021-07-13 15:15:00,83,13,9,10,115,normal,15,1,0
2021-07-13 15:30:00,50,6,15,9,80,low,15,1,0
2021-07-13 15:45:00,50,13,1,11,75,low,15,1,0
2021-07-13 16:00:00,65,5,1,20,91,normal,16,1,0
2021-07-13 16:15:00,72,8,12,19,111,normal,16,1,0
2021-07-13 16:30:00,80,7,0,9,96,low,16,1,0
2021-07-13 16:45:00,71,5,10,5,91,low,16,1,0
2021-07-13 17:00:00,83,11,2,12,108,low,17,1,0
2021-07-13 17:15:00,54,5,6,10,75,low,17,1,0
2021-07-13 17:30:00,55,6,4,10,75,low,17,1,0
2021-07-13 17:45:00,56,15,14,5,90,low,17,1,0
2021-07-13 18:00:00,71,8,13,12,104,low,18,1,0
2021-07-13 18:15:00,59,5,13,18,95,low,18,1,0
2021-07-13 18:30:00,62,14,4,10,90,low,18,1,0
2021-07-13 18:45:00,68,10,9,20,107,normal,18,1,0
2021-07-13 19:00:00,27,0,3,40,70,normal,19,1,0
2021-07-13 19:15:00,45,3,1,44,93,normal,19,1,0
2021-07-13 19:30:00,23,3,1,39,66,normal,19,1,0
2021-07-13 19:45:00,50,4,4,40,98,normal,19,1,0
2021-07-13 20:00:00,29,2,4,39,74,normal,20,1,0
2021-07-13 20:15:00,26,1,5,30,62,normal,20,1,0
2021-07-13 20:30:00,43,4,5,39,91,normal,20,1,0
2021-07-13 20:45:00,33,5,0,25,63,normal,20,1,0
2021-07-13 21:00:00,21,2,4,30,57,normal,21,1,0
2021-07-13 21:15:00,47,2,4,40,93,normal,21,1,0
2021-07-13 21:30:00,24,4,4,41,73,normal,21,1,0
2021-07-13 21:45:00,11,0,2,27,40,normal,21,1,0
2021-07-13 22:00:00,5,1,1,37,44,normal,22,1,0
2021-07-13 22:15:00,14,2,1,22,39,normal,22,1,0
2021-07-13 22:30:00,6,2,0,39,47,normal,22,1,0
2021-07-13 22:45:00,15,2,2,37,56,normal,22,1,0
2021-07-13 23:00:00,9,2,2,36,49,normal,23,1,0
2021-07-13 23:15:00,11,0,0,34,45,normal,23,1,0
2021-07-13 23:30:00,13,1,2,25,41,normal,23,1,0
2021-07-13 23:45:00,13,1,2,31,47,normal,23,1,0
2021-07-14 00:00:00,10,0,0,37,47,normal,0,2,0
2021-07-14 00:15:00,6,2,0,20,28,normal,0,2,0
2021-07-14 00:30:00,12,1,1,36,50,normal,0,2,0
2021-07-14 00:45:00,9,2,0,27,38,normal,0,2,0
2021-07-14 01:00:00,13,1,0,35,49,normal,1,2,0
2021-07-14 01:15:00,7,0,1,40,48,normal,1,2,0
2021-07-14 01:30:00,6,1,1,37,45,normal,1,2,0
2021-07-14 01:45:00,8,1,1,27,37,normal,1,2,0
2021-07-14 02:00:00,9,2,2,30,43,normal,2,2,0
2021-07-14 02:15:00,7,1,0,38,46,normal,2,2,0
2021-07-14 02:30:00,6,0,1,35,42,normal,2,2,0
2021-07-14 02:45:00,7,0,2,27,36,normal,2,2,0
2021-07-14 03:00:00,5,0,0,36,41,normal,3,2,0
2021-07-14 03:15:00,11,2,2,25,40,normal,3,2,0
2021-07-14 03:30:00,5,1,2,22,30,normal,3,2,0
2021-07-14 03:45:00,14,0,1,30,45,normal,3,2,0
2021-07-14 04:00:00,55,1,1,30,87,normal,4,2,0
2021-07-14 04:15:00,74,10,1,10,95,low,4,2,0
2021-07-14 04:30:00,89,7,1,21,118,normal,4,2,0
2021-07-14 04:45:00,87,9,6,17,119,normal,4,2,0
2021-07-14 05:00:00,80,10,3,19,112,normal,5,2,0
2021-07-14 05:15:00,89,7,0,25,121,normal,5,2,0
2021-07-14 05:30:00,89,6,6,17,118,normal,5,2,0
2021-07-14 05:45:00,134,12,20,5,171,heavy,5,2,0
2021-07-14 06:00:00,104,16,11,15,146,normal,6,2,0
2021-07-14 06:15:00,132,10,20,13,175,heavy,6,2,0
2021-07-14 06:30:00,112,16,18,12,158,normal,6,2,0
2021-07-14 06:45:00,84,25,11,15,135,normal,6,2,0
2021-07-14 07:00:00,101,25,21,15,162,normal,7,2,0
2021-07-14 07:15:00,141,16,25,10,192,heavy,7,2,0
2021-07-14 07:30:00,108,29,23,11,171,heavy,7,2,0
2021-07-14 07:45:00,147,27,25,7,206,heavy,7,2,0
2021-07-14 08:00:00,102,10,18,12,142,normal,8,2,0
2021-07-14 08:15:00,141,30,19,7,197,heavy,8,2,0
2021-07-14 08:30:00,118,23,19,15,175,heavy,8,2,0
2021-07-14 08:45:00,90,27,12,10,139,normal,8,2,0
2021-07-14 09:00:00,35,5,25,11,76,normal,9,2,0
2021-07-14 09:15:00,80,11,8,19,118,normal,9,2,0
2021-07-14 09:30:00,71,15,7,10,103,low,9,2,0
2021-07-14 09:45:00,58,5,5,7,75,low,9,2,0
2021-07-14 10:00:00,36,5,15,19,75,normal,10,2,0
2021-07-14 10:15:00,36,15,22,11,84,normal,10,2,0
2021-07-14 10:30:00,30,12,20,17,79,normal,10,2,0
2021-07-14 10:45:00,29,5,11,29,74,normal,10,2,0
2021-07-14 11:00:00,34,8,10,25,77,normal,11,2,0
2021-07-14 11:15:00,61,3,6,31,101,normal,11,2,0
2021-07-14 11:30:00,52,7,5,27,91,normal,11,2,0
2021-07-14 11:45:00,24,0,12,34,70,normal,11,2,0
2021-07-14 12:00:00,28,9,5,25,67,normal,12,2,0
2021-07-14 12:15:00,42,0,4,33,79,normal,12,2,0
2021-07-14 12:30:00,31,4,9,26,70,normal,12,2,0
2021-07-14 12:45:00,29,2,4,34,69,normal,12,2,0
2021-07-14 13:00:00,64,19,22,13,118,normal,13,2,0
2021-07-14 13:15:00,84,1,11,16,112,normal,13,2,0
2021-07-14 13:30:00,20,0,17,24,61,normal,13,2,0
2021-07-14 13:45:00,82,16,32,22,152,high,13,2,0
2021-07-14 14:00:00,80,14,22,25,141,normal,14,2,0
2021-07-14 14:15:00,18,16,10,14,58,low,14,2,0
2021-07-14 14:30:00,57,12,30,15,114,high,14,2,0
2021-07-14 14:45:00,50,1,21,25,97,normal,14,2,0
2021-07-14 15:00:00,6,4,5,10,25,low,15,2,0
2021-07-14 15:15:00,78,19,30,23,150,high,15,2,0
2021-07-14 15:30:00,38,8,18,30,94,normal,15,2,0
2021-07-14 15:45:00,129,18,12,17,176,heavy,15,2,0
2021-07-14 16:00:00,114,9,39,11,173,heavy,16,2,0
2021-07-14 16:15:00,139,8,40,17,204,heavy,16,2,0
2021-07-14 16:30:00,108,20,10,15,153,normal,16,2,0
2021-07-14 16:45:00,129,11,12,20,172,heavy,16,2,0
2021-07-14 17:00:00,149,22,31,13,215,heavy,17,2,0
2021-07-14 17:15:00,120,27,37,12,196,heavy,17,2,0
2021-07-14 17:30:00,120,6,37,18,181,heavy,17,2,0
2021-07-14 17:45:00,124,28,32,18,202,heavy,17,2,0
2021-07-14 18:00:00,116,10,28,19,173,heavy,18,2,0
2021-07-14 18:15:00,100,9,10,11,130,normal,18,2,0
2021-07-14 18:30:00,88,8,20,33,149,high,18,2,0
2021-07-14 18:45:00,94,16,15,20,145,normal,18,2,0
2021-07-14 19:00:00,94,17,19,35,165,high,19,2,0
2021-07-14 19:15:00,51,20,7,25,103,normal,19,2,0
2021-07-14 19:30:00,58,12,20,19,109,normal,19,2,0
2021-07-14 19:45:00,74,8,10,13,105,low,19,2,0
2021-07-14 20:00:00,92,9,11,32,144,high,20,2,0
2021-07-14 20:15:00,92,5,17,12,126,normal,20,2,0
2021-07-14 20:30:00,50,9,18,18,95,normal,20,2,0
2021-07-14 20:45:00,80,11,14,14,119,normal,20,2,0
2021-07-14 21:00:00,102,10,13,13,138,normal,21,2,0
2021-07-14 21:15:00,68,13,18,13,112,normal,21,2,0
2021-07-14 21:30:00,108,4,17,13,142,normal,21,2,0
2021-07-14 21:45:00,13,1,2,20,36,normal,21,2,0
2021-07-14 22:00:00,8,0,2,34,44,normal,22,2,0
2021-07-14 22:15:00,11,2,2,40,55,normal,22,2,0
2021-07-14 22:30:00,13,1,1,28,43,normal,22,2,0
2021-07-14 22:45:00,12,0,2,23,37,normal,22,2,0
2021-07-14 23:00:00,9,0,1,20,30,normal,23,2,0
2021-07-14 23:15:00,8,1,2,21,32,normal,23,2,0
2021-07-14 23:30:00,7,1,1,26,35,normal,23,2,0
2021-07-14 23:45:00,6,0,1,22,29,normal,23,2,0
2021-07-15 00:00:00,11,2,0,35,48,normal,0,3,0
2021-07-15 00:15:00,7,2,0,24,33,normal,0,3,0
2021-07-15 00:30:00,7,2,2,28,39,normal,0,3,0
2021-07-15 00:45:00,13,0,2,24,39,normal,0,3,0
2021-07-15 01:00:00,13,1,2,27,43,normal,1,3,0
2021-07-15 01:15:00,7,1,1,32,41,normal,1,3,0
2021-07-15 01:30:00,7,0,2,24,33,normal,1,3,0
2021-07-15 01:45:00,6,2,0,25,33,normal,1,3,0
2021-07-15 02:00:00,5,0,0,26,31,normal,2,3,0
2021-07-15 02:15:00,6,0,2,20,28,normal,2,3,0
2021-07-15 02:30:00,10,2,1,35,48,normal,2,3,0
2021-07-15 02:45:00,14,1,0,22,37,normal,2,3,0
2021-07-15 03:00:00,13,1,1,24,39,normal,3,3,0
2021-07-15 03:15:00,13,1,1,23,38,normal,3,3,0
2021-07-15 03:30:00,15,0,0,39,54,normal,3,3,0
2021-07-15 03:45:00,9,2,2,25,38,normal,3,3,0
2021-07-15 04:00:00,76,7,2,14,99,low,4,3,0
2021-07-15 04:15:00,75,4,4,23,106,normal,4,3,0
2021-07-15 04:30:00,54,8,0,16,78,low,4,3,0
2021-07-15 04:45:00,60,5,6,25,96,normal,4,3,0
2021-07-15 05:00:00,70,4,6,21,101,normal,5,3,0
2021-07-15 05:15:00,70,10,7,24,111,normal,5,3,0
2021-07-15 05:30:00,50,2,3,26,81,normal,5,3,0
2021-07-15 05:45:00,128,11,25,13,177,heavy,5,3,0
2021-07-15 06:00:00,131,23,15,11,180,heavy,6,3,0
2021-07-15 06:15:00,140,24,17,8,189,heavy,6,3,0
2021-07-15 06:30:00,113,23,23,10,169,heavy,6,3,0
2021-07-15 06:45:00,109,22,13,8,152,normal,6,3,0
2021-07-15 07:00:00,143,11,11,12,177,heavy,7,3,0
2021-07-15 07:15:00,137,24,25,8,194,heavy,7,3,0
2021-07-15 07:30:00,109,27,14,8,158,normal,7,3,0
2021-07-15 07:45:00,87,30,17,8,142,normal,7,3,0
2021-07-15 08:00:00,91,14,13,5,123,normal,8,3,0
2021-07-15 08:15:00,86,15,16,14,131,normal,8,3,0
2021-07-15 08:30:00,134,13,24,11,182,heavy,8,3,0
2021-07-15 08:45:00,137,13,20,9,179,heavy,8,3,0
2021-07-15 09:00:00,47,15,26,15,103,normal,9,3,0
2021-07-15 09:15:00,52,8,23,17,100,normal,9,3,0
2021-07-15 09:30:00,77,5,5,14,101,low,9,3,0
2021-07-15 09:45:00,43,13,24,14,94,normal,9,3,0
2021-07-15 10:00:00,68,14,30,19,131,high,10,3,0
2021-07-15 10:15:00,46,5,11,13,75,low,10,3,0
2021-07-15 10:30:00,80,11,5,16,112,normal,10,3,0
2021-07-15 10:45:00,43,8,1,27,79,normal,10,3,0
2021-07-15 11:00:00,66,7,12,27,112,normal,11,3,0
2021-07-15 11:15:00,34,0,2,33,69,normal,11,3,0
2021-07-15 11:30:00,65,2,8,30,105,normal,11,3,0
2021-07-15 11:45:00,59,7,9,29,104,normal,11,3,0
2021-07-15 12:00:00,55,7,4,28,94,normal,12,3,0
2021-07-15 12:15:00,41,4,9,35,89,normal,12,3,0
2021-07-15 12:30:00,32,0,8,25,65,normal,12,3,0
2021-07-15 12:45:00,48,2,12,30,92,normal,12,3,0
2021-07-15 13:00:00,36,16,12,13,77,low,13,3,0
2021-07-15 13:15:00,43,2,23,22,90,normal,13,3,0
2021-07-15 13:30:00,13,3,24,30,70,normal,13,3,0
2021-07-15 13:45:00,90,20,22,18,150,normal,13,3,0
2021-07-15 14:00:00,98,4,20,28,150,normal,14,3,0
2021-07-15 14:15:00,95,6,27,14,142,high,14,3,0
2021-07-15 14:30:00,39,13,8,11,71,low,14,3,0
2021-07-15 14:45:00,54,15,8,11,88,low,14,3,0
2021-07-15 15:00:00,28,19,13,11,71,low,15,3,0
2021-07-15 15:15:00,7,4,5,23,39,normal,15,3,0
2021-07-15 15:30:00,29,18,9,15,71,low,15,3,0
2021-07-15 15:45:00,122,18,18,19,177,heavy,15,3,0
2021-07-15 16:00:00,150,30,14,17,211,heavy,16,3,0
2021-07-15 16:15:00,113,25,28,12,178,heavy,16,3,0
2021-07-15 16:30:00,116,23,39,17,195,heavy,16,3,0
2021-07-15 16:45:00,127,14,40,11,192,heavy,16,3,0
2021-07-15 17:00:00,116,15,33,20,184,heavy,17,3,0
2021-07-15 17:15:00,136,15,15,18,184,heavy,17,3,0
2021-07-15 17:30:00,120,17,14,11,162,normal,17,3,0
2021-07-15 17:45:00,109,25,35,12,181,heavy,17,3,0
2021-07-15 18:00:00,134,21,26,15,196,heavy,18,3,0
2021-07-15 18:15:00,135,10,36,15,196,heavy,18,3,0
2021-07-15 18:30:00,77,1,10,25,113,normal,18,3,0
2021-07-15 18:45:00,107,15,13,11,146,normal,18,3,0
2021-07-15 19:00:00,106,16,5,19,146,normal,19,3,0
2021-07-15 19:15:00,52,17,5,16,90,low,19,3,0
2021-07-15 19:30:00,100,19,5,22,146,normal,19,3,0
2021-07-15 19:45:00,107,13,13,22,155,normal,19,3,0
2021-07-15 20:00:00,67,7,20,33,127,high,20,3,0
2021-07-15 20:15:00,100,15,10,11,136,normal,20,3,0
2021-07-15 20:30:00,110,1,18,20,149,normal,20,3,0
2021-07-15 20:45:00,92,14,10,11,127,normal,20,3,0
2021-07-15 21:00:00,109,14,16,14,153,normal,21,3,0
2021-07-15 21:15:00,85,17,11,28,141,normal,21,3,0
2021-07-15 21:30:00,101,12,16,12,141,normal,21,3,0
2021-07-15 21:45:00,10,0,0,25,35,normal,21,3,0
2021-07-15 22:00:00,12,2,1,32,47,normal,22,3,0
2021-07-15 22:15:00,13,2,0,40,55,normal,22,3,0
2021-07-15 22:30:00,15,1,0,30,46,normal,22,3,0
2021-07-15 22:45:00,6,1,0,34,41,normal,22,3,0
2021-07-15 23:00:00,11,1,1,39,52,normal,23,3,0
2021-07-15 23:15:00,9,2,1,23,35,normal,23,3,0
2021-07-15 23:30:00,10,2,2,28,42,normal,23,3,0
2021-07-15 23:45:00,12,0,1,38,51,normal,23,3,0
2021-07-16 00:00:00,11,2,2,39,54,normal,0,4,0
2021-07-16 00:15:00,7,1,0,29,37,normal,0,4,0
2021-07-16 00:30:00,15,0,2,33,50,normal,0,4,0
2021-07-16 00:45:00,10,0,0,20,30,normal,0,4,0
2021-07-16 01:00:00,6,0,1,40,47,normal,1,4,0
2021-07-16 01:15:00,12,1,2,31,46,normal,1,4,0
2021-07-16 01:30:00,15,0,0,26,41,normal,1,4,0
2021-07-16 01:45:00,10,0,1,31,42,normal,1,4,0
2021-07-16 02:00:00,9,0,2,38,49,normal,2,4,0
2021-07-16 02:15:00,9,2,2,37,50,normal,2,4,0
2021-07-16 02:30:00,7,0,0,34,41,normal,2,4,0
2021-07-16 02:45:00,12,2,1,26,41,normal,2,4,0
2021-07-16 03:00:00,15,0,0,34,49,normal,3,4,0
2021-07-16 03:15:00,11,0,1,29,41,normal,3,4,0
2021-07-16 03:30:00,9,1,1,30,41,normal,3,4,0
2021-07-16 03:45:00,5,2,0,28,35,normal,3,4,0
2021-07-16 04:00:00,70,1,0,25,96,normal,4,4,0
2021-07-16 04:15:00,74,0,6,25,105,normal,4,4,0
2021-07-16 04:30:00,81,3,1,20,105,normal,4,4,0
2021-07-16 04:45:00,71,2,4,21,98,normal,4,4,0
2021-07-16 05:00:00,75,7,1,28,111,normal,5,4,0
2021-07-16 05:15:00,88,5,5,25,123,normal,5,4,0
2021-07-16 05:30:00,71,2,4,19,96,normal,5,4,0
2021-07-16 05:45:00,115,10,11,15,151,normal,5,4,0
2021-07-16 06:00:00,147,26,11,5,189,heavy,6,4,0
2021-07-16 06:15:00,102,15,20,10,147,normal,6,4,0
2021-07-16 06:30:00,80,12,25,9,126,normal,6,4,0
2021-07-16 06:45:00,97,23,25,7,152,normal,6,4,0
2021-07-16 07:00:00,81,23,24,8,136,normal,7,4,0
2021-07-16 07:15:00,130,16,10,15,171,heavy,7,4,0
2021-07-16 07:30:00,103,13,24,13,153,normal,7,4,0
2021-07-16 07:45:00,138,22,20,8,188,heavy,7,4,0
2021-07-16 08:00:00,128,16,22,12,178,heavy,8,4,0
2021-07-16 08:15:00,91,14,11,8,124,normal,8,4,0
2021-07-16 08:30:00,141,27,12,9,189,heavy,8,4,0
2021-07-16 08:45:00,114,19,25,5,163,normal,8,4,0
2021-07-16 09:00:00,53,14,30,10,107,normal,9,4,0
2021-07-16 09:15:00,69,9,17,5,100,normal,9,4,0
2021-07-16 09:30:00,39,8,16,10,73,normal,9,4,0
2021-07-16 09:45:00,71,13,25,8,117,normal,9,4,0
2021-07-16 10:00:00,48,8,29,12,97,normal,10,4,0
2021-07-16 10:15:00,73,14,18,17,122,normal,10,4,0
2021-07-16 10:30:00,61,8,7,18,94,low,10,4,0
2021-07-16 10:45:00,44,7,11,30,92,normal,10,4,0
2021-07-16 11:00:00,59,0,7,35,101,normal,11,4,0
2021-07-16 11:15:00,50,3,5,29,87,normal,11,4,0
2021-07-16 11:30:00,26,3,5,28,62,normal,11,4,0
2021-07-16 11:45:00,24,7,13,34,78,normal,11,4,0
2021-07-16 12:00:00,35,3,3,33,74,normal,12,4,0
2021-07-16 12:15:00,59,10,9,25,103,normal,12,4,0
2021-07-16 12:30:00,31,2,5,33,71,normal,12,4,0
2021-07-16 12:45:00,21,10,7,31,69,normal,12,4,0
2021-07-16 13:00:00,68,20,24,14,126,normal,13,4,0
2021-07-16 13:15:00,31,4,21,22,78,normal,13,4,0
2021-07-16 13:30:00,44,6,18,17,85,normal,13,4,0
2021-07-16 13:45:00,39,16,27,26,108,normal,13,4,0
2021-07-16 14:00:00,25,19,35,18,97,normal,14,4,0
2021-07-16 14:15:00,16,4,29,14,63,normal,14,4,0
2021-07-16 14:30:00,8,11,24,12,55,normal,14,4,0
2021-07-16 14:45:00,35,18,3,16,72,low,14,4,0
2021-07-16 15:00:00,95,16,16,21,148,normal,15,4,0
2021-07-16 15:15:00,8,3,32,22,65,normal,15,4,0
2021-07-16 15:30:00,30,19,14,18,81,low,15,4,0
2021-07-16 15:45:00,125,11,26,11,173,heavy,15,4,0
2021-07-16 16:00:00,130,10,30,20,190,heavy,16,4,0
2021-07-16 16:15:00,149,27,24,19,219,heavy,16,4,0
2021-07-16 16:30:00,107,25,38,14,184,heavy,16,4,0
2021-07-16 16:45:00,129,16,23,10,178,heavy,16,4,0
2021-07-16 17:00:00,131,7,33,13,184,heavy,17,4,0
2021-07-16 17:15:00,124,20,13,14,171,heavy,17,4,0
2021-07-16 17:30:00,102,20,17,16,155,normal,17,4,0
2021-07-16 17:45:00,144,13,12,20,189,heavy,17,4,0
2021-07-16 18:00:00,148,9,37,18,212,heavy,18,4,0
2021-07-16 18:15:00,141,11,33,16,201,heavy,18,4,0
2021-07-16 18:30:00,96,18,5,30,149,normal,18,4,0
2021-07-16 18:45:00,85,7,13,31,136,high,18,4,0
2021-07-16 19:00:00,101,0,19,33,153,high,19,4,0
2021-07-16 19:15:00,83,1,6,24,114,normal,19,4,0
2021-07-16 19:30:00,61,10,13,30,114,normal,19,4,0
2021-07-16 19:45:00,101,6,20,27,154,normal,19,4,0
2021-07-16 20:00:00,107,0,15,27,149,normal,20,4,0
2021-07-16 20:15:00,78,3,12,33,126,high,20,4,0
2021-07-16 20:30:00,77,20,7,22,126,normal,20,4,0
2021-07-16 20:45:00,108,10,5,21,144,normal,20,4,0
2021-07-16 21:00:00,55,0,19,25,99,normal,21,4,0
2021-07-16 21:15:00,61,10,14,35,120,high,21,4,0
2021-07-16 21:30:00,88,18,7,23,136,normal,21,4,0
2021-07-16 21:45:00,7,0,1,38,46,normal,21,4,0
2021-07-16 22:00:00,12,0,0,35,47,normal,22,4,0
2021-07-16 22:15:00,7,2,1,35,45,normal,22,4,0
2021-07-16 22:30:00,14,2,1,21,38,normal,22,4,0
2021-07-16 22:45:00,10,1,1,20,32,normal,22,4,0
2021-07-16 23:00:00,6,2,0,31,39,normal,23,4,0
2021-07-16 23:15:00,5,2,1,40,48,normal,23,4,0
2021-07-16 23:30:00,14,0,2,40,56,normal,23,4,0
2021-07-16 23:45:00,6,0,2,32,40,normal,23,4,0
2021-07-17 00:00:00,14,0,2,27,43,normal,0,5,0
2021-07-17 00:15:00,8,1,1,21,31,normal,0,5,0
2021-07-17 00:30:00,11,2,2,21,36,normal,0,5,0
2021-07-17 00:45:00,10,2,0,33,45,normal,0,5,0
2021-07-17 01:00:00,13,1,2,29,45,normal,1,5,0
2021-07-17 01:15:00,6,2,0,27,35,normal,1,5,0
2021-07-17 01:30:00,7,2,0,22,31,normal,1,5,0
2021-07-17 01:45:00,5,2,2,37,46,normal,1,5,0
2021-07-17 02:00:00,14,2,1,40,57,normal,2,5,0
2021-07-17 02:15:00,14,0,0,31,45,normal,2,5,0
2021-07-17 02:30:00,10,0,2,39,51,normal,2,5,0
2021-07-17 02:45:00,8,2,0,40,50,normal,2,5,0
2021-07-17 03:00:00,15,0,1,35,51,normal,3,5,0
2021-07-17 03:15:00,11,1,1,37,50,normal,3,5,0
2021-07-17 03:30:00,15,1,2,27,45,normal,3,5,0
2021-07-17 03:45:00,15,2,1,40,58,normal,3,5,0
2021-07-17 04:00:00,83,9,0,14,106,low,4,5,0
2021-07-17 04:15:00,82,3,0,30,115,normal,4,5,0
2021-07-17 04:30:00,76,4,6,15,101,low,4,5,0
2021-07-17 04:45:00,59,5,2,11,77,low,4,5,0
2021-07-17 05:00:00,59,5,3,27,94,normal,5,5,0
2021-07-17 05:15:00,71,4,6,17,98,low,5,5,0
2021-07-17 05:30:00,70,4,4,23,101,normal,5,5,0
2021-07-17 05:45:00,104,11,19,9,143,normal,5,5,0
2021-07-17 06:00:00,136,30,11,5,182,heavy,6,5,0
2021-07-17 06:15:00,86,13,21,9,129,normal,6,5,0
2021-07-17 06:30:00,131,19,18,11,179,heavy,6,5,0
2021-07-17 06:45:00,90,16,14,13,133,normal,6,5,0
2021-07-17 07:00:00,129,13,17,5,164,normal,7,5,0
2021-07-17 07:15:00,91,10,25,14,140,normal,7,5,0
2021-07-17 07:30:00,86,10,20,14,130,normal,7,5,0
2021-07-17 07:45:00,100,19,17,8,144,normal,7,5,0
2021-07-17 08:00:00,84,11,10,11,116,normal,8,5,0
2021-07-17 08:15:00,109,29,25,11,174,heavy,8,5,0
2021-07-17 08:30:00,93,22,15,8,138,normal,8,5,0
2021-07-17 08:45:00,92,17,16,5,130,normal,8,5,0
2021-07-17 09:00:00,80,7,11,17,115,normal,9,5,0
2021-07-17 09:15:00,30,11,24,7,72,normal,9,5,0
2021-07-17 09:30:00,35,14,14,12,75,low,9,5,0
2021-07-17 09:45:00,70,5,25,7,107,normal,9,5,0
2021-07-17 10:00:00,59,10,7,16,92,low,10,5,0
2021-07-17 10:15:00,56,12,7,6,81,low,10,5,0
2021-07-17 10:30:00,77,10,5,18,110,low,10,5,0
2021-07-17 10:45:00,64,2,10,34,110,normal,10,5,0
2021-07-17 11:00:00,37,3,13,28,81,normal,11,5,0
2021-07-17 11:15:00,51,6,8,33,98,normal,11,5,0
2021-07-17 11:30:00,33,1,9,30,73,normal,11,5,0
2021-07-17 11:45:00,70,1,11,31,113,high,11,5,0
2021-07-17 12:00:00,39,0,1,26,66,normal,12,5,0
2021-07-17 12:15:00,49,4,11,35,99,normal,12,5,0
2021-07-17 12:30:00,33,2,0,25,60,normal,12,5,0
2021-07-17 12:45:00,49,8,1,32,90,normal,12,5,0
2021-07-17 13:00:00,70,2,16,14,102,normal,13,5,0
2021-07-17 13:15:00,23,16,20,26,85,normal,13,5,0
2021-07-17 13:30:00,17,8,12,10,47,low,13,5,0
2021-07-17 13:45:00,37,2,7,29,75,normal,13,5,0
2021-07-17 14:00:00,38,1,0,10,49,low,14,5,0
2021-07-17 14:15:00,8,17,20,18,63,normal,14,5,0
2021-07-17 14:30:00,24,16,29,23,92,normal,14,5,0
2021-07-17 14:45:00,11,0,17,26,54,normal,14,5,0
2021-07-17 15:00:00,15,3,20,28,66,normal,15,5,0
2021-07-17 15:15:00,59,15,31,29,134,high,15,5,0
2021-07-17 15:30:00,7,11,17,25,60,normal,15,5,0
2021-07-17 15:45:00,116,19,35,11,181,heavy,15,5,0
2021-07-17 16:00:00,123,5,31,13,172,heavy,16,5,0
2021-07-17 16:15:00,107,16,17,11,151,normal,16,5,0
2021-07-17 16:30:00,117,6,17,16,156,normal,16,5,0
2021-07-17 16:45:00,102,10,15,11,138,normal,16,5,0
2021-07-17 17:00:00,100,12,14,15,141,normal,17,5,0
2021-07-17 17:15:00,142,22,25,18,207,heavy,17,5,0
2021-07-17 17:30:00,104,19,12,16,151,normal,17,5,0
2021-07-17 17:45:00,105,23,17,13,158,normal,17,5,0
2021-07-17 18:00:00,101,30,23,18,172,heavy,18,5,0
2021-07-17 18:15:00,138,16,14,19,187,heavy,18,5,0
2021-07-17 18:30:00,96,5,18,26,145,normal,18,5,0
2021-07-17 18:45:00,70,17,20,34,141,high,18,5,0
2021-07-17 19:00:00,62,10,15,26,113,normal,19,5,0
2021-07-17 19:15:00,101,18,15,15,149,normal,19,5,0
2021-07-17 19:30:00,83,1,5,31,120,high,19,5,0
2021-07-17 19:45:00,104,20,20,20,164,normal,19,5,0
2021-07-17 20:00:00,107,9,6,20,142,normal,20,5,0
2021-07-17 20:15:00,100,2,11,23,136,normal,20,5,0
2021-07-17 20:30:00,110,2,18,21,151,normal,20,5,0
2021-07-17 20:45:00,110,2,14,31,157,high,20,5,0
2021-07-17 21:00:00,65,20,14,17,116,normal,21,5,0
2021-07-17 21:15:00,53,18,10,35,116,high,21,5,0
2021-07-17 21:30:00,65,2,13,33,113,high,21,5,0
2021-07-17 21:45:00,14,0,0,26,40,normal,21,5,0
2021-07-17 22:00:00,7,1,0,24,32,normal,22,5,0
2021-07-17 22:15:00,8,0,0,21,29,normal,22,5,0
2021-07-17 22:30:00,15,0,0,32,47,normal,22,5,0
2021-07-17 22:45:00,15,2,2,20,39,normal,22,5,0
2021-07-17 23:00:00,11,1,0,37,49,normal,23,5,0
2021-07-17 23:15:00,5,0,0,37,42,normal,23,5,0
2021-07-17 23:30:00,10,2,2,28,42,normal,23,5,0
2021-07-17 23:45:00,15,0,2,40,57,normal,23,5,0
2021-07-18 00:00:00,11,2,0,39,52,normal,0,6,1
2021-07-18 00:15:00,11,2,1,28,42,normal,0,6,1
2021-07-18 00:30:00,5,1,1,29,36,normal,0,6,1
2021-07-18 00:45:00,7,2,0,27,36,normal,0,6,1
2021-07-18 01:00:00,7,2,1,22,32,normal,1,6,1
2021-07-18 01:15:00,10,2,1,38,51,normal,1,6,1
2021-07-18 01:30:00,6,1,2,25,34,normal,1,6,1
2021-07-18 01:45:00,15,2,1,27,45,normal,1,6,1
2021-07-18 02:00:00,7,1,0,36,44,normal,2,6,1
2021-07-18 02:15:00,14,2,0,38,54,normal,2,6,1
2021-07-18 02:30:00,15,2,0,27,44,normal,2,6,1
2021-07-18 02:45:00,6,1,1,30,38,normal,2,6,1
2021-07-18 03:00:00,7,0,1,24,32,normal,3,6,1
2021-07-18 03:15:00,13,0,1,24,38,normal,3,6,1
2021-07-18 03:30:00,11,2,2,22,37,normal,3,6,1
2021-07-18 03:45:00,13,2,1,36,52,normal,3,6,1
2021-07-18 04:00:00,88,6,5,19,118,normal,4,6,1
2021-07-18 04:15:00,60,0,6,18,84,low,4,6,1
2021-07-18 04:30:00,54,6,6,14,80,low,4,6,1
2021-07-18 04:45:00,66,0,2,20,88,normal,4,6,1
2021-07-18 05:00:00,68,6,6,11,91,low,5,6,1
2021-07-18 05:15:00,89,9,1,14,113,normal,5,6,1
2021-07-18 05:30:00,56,1,0,24,81,normal,5,6,1
2021-07-18 05:45:00,101,24,15,9,149,normal,5,6,1
2021-07-18 06:00:00,120,28,20,10,178,heavy,6,6,1
2021-07-18 06:15:00,95,29,18,12,154,normal,6,6,1
2021-07-18 06:30:00,94,13,21,11,139,normal,6,6,1
2021-07-18 06:45:00,141,30,24,12,207,heavy,6,6,1
2021-07-18 07:00:00,144,26,18,13,201,heavy,7,6,1
2021-07-18 07:15:00,107,26,22,11,166,normal,7,6,1
2021-07-18 07:30:00,118,27,10,12,167,low,7,6,1
2021-07-18 07:45:00,136,16,24,10,186,heavy,7,6,1
2021-07-18 08:00:00,139,30,21,15,205,heavy,8,6,1
2021-07-18 08:15:00,103,19,15,14,151,normal,8,6,1
2021-07-18 08:30:00,127,18,11,15,171,heavy,8,6,1
2021-07-18 08:45:00,101,29,16,8,154,normal,8,6,1
2021-07-18 09:00:00,55,8,20,19,102,normal,9,6,1
2021-07-18 09:15:00,56,7,8,14,85,low,9,6,1
2021-07-18 09:30:00,34,7,8,9,58,low,9,6,1
2021-07-18 09:45:00,57,10,15,12,94,low,9,6,1
2021-07-18 10:00:00,44,15,9,18,86,low,10,6,1
2021-07-18 10:15:00,43,7,25,11,86,normal,10,6,1
2021-07-18 10:30:00,41,9,26,6,82,normal,10,6,1
2021-07-18 10:45:00,32,2,6,30,70,normal,10,6,1
2021-07-18 11:00:00,38,10,3,32,83,normal,11,6,1
2021-07-18 11:15:00,56,10,9,35,110,normal,11,6,1
2021-07-18 11:30:00,30,4,11,35,80,normal,11,6,1
2021-07-18 11:45:00,66,2,3,26,97,normal,11,6,1
2021-07-18 12:00:00,40,10,0,28,78,normal,12,6,1
2021-07-18 12:15:00,50,8,8,25,91,normal,12,6,1
2021-07-18 12:30:00,26,3,6,26,61,normal,12,6,1
2021-07-18 12:45:00,50,8,7,33,98,normal,12,6,1
2021-07-18 13:00:00,15,7,12,25,59,normal,13,6,1
2021-07-18 13:15:00,57,17,14,28,116,normal,13,6,1
2021-07-18 13:30:00,47,10,13,13,83,low,13,6,1
2021-07-18 13:45:00,12,4,11,23,50,normal,13,6,1
2021-07-18 14:00:00,49,8,4,16,77,low,14,6,1
2021-07-18 14:15:00,55,2,35,21,113,high,14,6,1
2021-07-18 14:30:00,44,9,10,26,89,normal,14,6,1
2021-07-18 14:45:00,73,9,28,17,127,high,14,6,1
2021-07-18 15:00:00,36,4,26,12,78,normal,15,6,1
2021-07-18 15:15:00,67,1,12,17,97,low,15,6,1
2021-07-18 15:30:00,44,16,17,11,88,normal,15,6,1
2021-07-18 15:45:00,145,14,35,10,204,heavy,15,6,1
2021-07-18 16:00:00,107,10,32,10,159,high,16,6,1
2021-07-18 16:15:00,100,17,31,15,163,high,16,6,1
2021-07-18 16:30:00,126,20,37,10,193,heavy,16,6,1
2021-07-18 16:45:00,147,23,39,13,222,heavy,16,6,1
2021-07-18 17:00:00,133,6,18,10,167,normal,17,6,1
2021-07-18 17:15:00,147,29,10,18,204,heavy,17,6,1
2021-07-18 17:30:00,115,11,27,13,166,high,17,6,1
2021-07-18 17:45:00,132,12,19,15,178,heavy,17,6,1
2021-07-18 18:00:00,106,23,20,13,162,normal,18,6,1
2021-07-18 18:15:00,119,28,37,12,196,heavy,18,6,1
2021-07-18 18:30:00,77,18,10,14,119,normal,18,6,1
2021-07-18 18:45:00,89,4,11,12,116,normal,18,6,1
2021-07-18 19:00:00,106,5,13,17,141,normal,19,6,1
2021-07-18 19:15:00,52,11,18,11,92,normal,19,6,1
2021-07-18 19:30:00,84,7,9,19,119,normal,19,6,1
2021-07-18 19:45:00,84,15,7,27,133,normal,19,6,1
2021-07-18 20:00:00,93,0,11,27,131,normal,20,6,1
2021-07-18 20:15:00,73,20,14,31,138,high,20,6,1
2021-07-18 20:30:00,50,16,5,32,103,normal,20,6,1
2021-07-18 20:45:00,66,11,20,29,126,normal,20,6,1
2021-07-18 21:00:00,63,8,6,13,90,low,21,6,1
2021-07-18 21:15:00,91,20,7,24,142,normal,21,6,1
2021-07-18 21:30:00,104,5,12,22,143,normal,21,6,1
2021-07-18 21:45:00,6,0,1,27,34,normal,21,6,1
2021-07-18 22:00:00,6,2,0,35,43,normal,22,6,1
2021-07-18 22:15:00,14,0,0,24,38,normal,22,6,1
2021-07-18 22:30:00,15,1,2,27,45,normal,22,6,1
2021-07-18 22:45:00,10,0,0,29,39,normal,22,6,1
2021-07-18 23:00:00,7,0,2,35,44,normal,23,6,1
2021-07-18 23:15:00,7,2,0,30,39,normal,23,6,1
2021-07-18 23:30:00,8,2,2,20,32,normal,23,6,1
2021-07-18 23:45:00,5,1,2,34,42,normal,23,6,1
2021-07-19 00:00:00,7,2,1,31,41,normal,0,0,0
2021-07-19 00:15:00,8,0,2,34,44,normal,0,0,0
2021-07-19 00:30:00,6,0,1,26,33,normal,0,0,0
2021-07-19 00:45:00,5,0,0,25,30,normal,0,0,0
2021-07-19 01:00:00,11,1,1,25,38,normal,1,0,0
2021-07-19 01:15:00,8,1,2,25,36,normal,1,0,0
2021-07-19 01:30:00,15,2,2,38,57,normal,1,0,0
2021-07-19 01:45:00,8,0,2,32,42,normal,1,0,0
2021-07-19 02:00:00,7,0,0,32,39,normal,2,0,0
2021-07-19 02:15:00,14,2,1,22,39,normal,2,0,0
2021-07-19 02:30:00,14,2,2,32,50,normal,2,0,0
2021-07-19 02:45:00,9,2,2,40,53,normal,2,0,0
2021-07-19 03:00:00,5,2,0,29,36,normal,3,0,0
2021-07-19 03:15:00,11,1,1,32,45,normal,3,0,0
2021-07-19 03:30:00,7,2,2,38,49,normal,3,0,0
2021-07-19 03:45:00,7,0,1,33,41,normal,3,0,0
2021-07-19 04:00:00,65,9,2,19,95,normal,4,0,0
2021-07-19 04:15:00,50,0,7,22,79,normal,4,0,0
2021-07-19 04:30:00,61,7,1,14,83,low,4,0,0
2021-07-19 04:45:00,77,6,3,28,114,normal,4,0,0
2021-07-19 05:00:00,80,7,3,28,118,normal,5,0,0
2021-07-19 05:15:00,66,1,4,25,96,normal,5,0,0
2021-07-19 05:30:00,89,3,5,21,118,normal,5,0,0
2021-07-19 05:45:00,87,25,13,13,138,normal,5,0,0
2021-07-19 06:00:00,94,26,24,10,154,normal,6,0,0
2021-07-19 06:15:00,116,20,11,11,158,normal,6,0,0
2021-07-19 06:30:00,127,20,13,14,174,heavy,6,0,0
2021-07-19 06:45:00,130,13,14,13,170,heavy,6,0,0
2021-07-19 07:00:00,86,12,13,14,125,normal,7,0,0
2021-07-19 07:15:00,116,11,22,14,163,normal,7,0,0
2021-07-19 07:30:00,115,13,13,8,149,normal,7,0,0
2021-07-19 07:45:00,99,14,24,12,149,normal,7,0,0
2021-07-19 08:00:00,86,23,20,13,142,normal,8,0,0
2021-07-19 08:15:00,81,25,19,8,133,normal,8,0,0
2021-07-19 08:30:00,113,10,15,11,149,normal,8,0,0
2021-07-19 08:45:00,147,18,20,5,190,heavy,8,0,0
2021-07-19 09:00:00,49,6,26,16,97,normal,9,0,0
2021-07-19 09:15:00,79,5,13,19,116,normal,9,0,0
2021-07-19 09:30:00,32,5,26,17,80,normal,9,0,0
2021-07-19 09:45:00,51,15,9,13,88,low,9,0,0
2021-07-19 10:00:00,33,10,25,17,85,normal,10,0,0
2021-07-19 10:15:00,49,7,15,6,77,low,10,0,0
2021-07-19 10:30:00,54,13,5,6,78,low,10,0,0
2021-07-19 10:45:00,28,1,6,32,67,normal,10,0,0
2021-07-19 11:00:00,43,0,5,33,81,normal,11,0,0
2021-07-19 11:15:00,52,2,12,30,96,normal,11,0,0
2021-07-19 11:30:00,25,7,8,25,65,normal,11,0,0
2021-07-19 11:45:00,28,8,12,30,78,normal,11,0,0
2021-07-19 12:00:00,67,0,1,28,96,normal,12,0,0
2021-07-19 12:15:00,58,9,3,26,96,normal,12,0,0
2021-07-19 12:30:00,53,1,13,32,99,normal,12,0,0
2021-07-19 12:45:00,63,6,7,31,107,normal,12,0,0
2021-07-19 13:00:00,42,2,34,27,105,normal,13,0,0
2021-07-19 13:15:00,27,8,10,12,57,low,13,0,0
2021-07-19 13:30:00,78,5,5,25,113,normal,13,0,0
2021-07-19 13:45:00,93,0,5,16,114,normal,13,0,0
2021-07-19 14:00:00,66,18,29,10,123,high,14,0,0
2021-07-19 14:15:00,42,20,18,22,102,normal,14,0,0
2021-07-19 14:30:00,63,3,29,15,110,normal,14,0,0
2021-07-19 14:45:00,13,20,9,27,69,normal,14,0,0
2021-07-19 15:00:00,55,1,28,16,100,normal,15,0,0
2021-07-19 15:15:00,67,4,23,14,108,normal,15,0,0
2021-07-19 15:30:00,65,6,0,26,97,normal,15,0,0
2021-07-19 15:45:00,141,6,33,12,192,heavy,15,0,0
2021-07-19 16:00:00,145,13,19,10,187,heavy,16,0,0
2021-07-19 16:15:00,103,29,11,16,159,normal,16,0,0
2021-07-19 16:30:00,112,20,10,19,161,normal,16,0,0
2021-07-19 16:45:00,101,11,38,18,168,heavy,16,0,0
2021-07-19 17:00:00,142,28,34,20,224,heavy,17,0,0
2021-07-19 17:15:00,124,21,13,11,169,heavy,17,0,0
2021-07-19 17:30:00,115,22,15,19,171,heavy,17,0,0
2021-07-19 17:45:00,103,28,17,17,165,normal,17,0,0
2021-07-19 18:00:00,104,16,15,18,153,normal,18,0,0
2021-07-19 18:15:00,141,20,12,16,189,heavy,18,0,0
2021-07-19 18:30:00,72,19,11,23,125,normal,18,0,0
2021-07-19 18:45:00,67,10,19,34,130,high,18,0,0
2021-07-19 19:00:00,56,7,18,34,115,high,19,0,0
2021-07-19 19:15:00,99,13,16,34,162,high,19,0,0
2021-07-19 19:30:00,103,19,8,30,160,normal,19,0,0
2021-07-19 19:45:00,58,7,9,26,100,normal,19,0,0
2021-07-19 20:00:00,59,7,14,28,108,normal,20,0,0
2021-07-19 20:15:00,94,20,12,20,146,normal,20,0,0
2021-07-19 20:30:00,83,15,16,18,132,normal,20,0,0
2021-07-19 20:45:00,89,1,18,14,122,normal,20,0,0
2021-07-19 21:00:00,52,13,16,13,94,normal,21,0,0
2021-07-19 21:15:00,53,15,5,22,95,normal,21,0,0
2021-07-19 21:30:00,60,0,14,11,85,low,21,0,0
2021-07-19 21:45:00,10,2,0,37,49,normal,21,0,0
2021-07-19 22:00:00,11,1,2,33,47,normal,22,0,0
2021-07-19 22:15:00,5,0,0,40,45,normal,22,0,0
2021-07-19 22:30:00,11,1,0,31,43,normal,22,0,0
2021-07-19 22:45:00,14,2,0,24,40,normal,22,0,0
2021-07-19 23:00:00,10,0,2,26,38,normal,23,0,0
2021-07-19 23:15:00,13,0,2,36,51,normal,23,0,0
2021-07-19 23:30:00,9,1,1,29,40,normal,23,0,0
2021-07-19 23:45:00,10,0,2,22,34,normal,23,0,0
2021-07-20 00:00:00,13,2,0,26,41,normal,0,1,0
2021-07-20 00:15:00,7,2,1,21,31,normal,0,1,0
2021-07-20 00:30:00,8,1,0,40,49,normal,0,1,0
2021-07-20 00:45:00,10,2,0,20,32,normal,0,1,0
2021-07-20 01:00:00,13,0,2,22,37,normal,1,1,0
2021-07-20 01:15:00,15,2,1,40,58,normal,1,1,0
2021-07-20 01:30:00,10,2,0,23,35,normal,1,1,0
2021-07-20 01:45:00,7,0,2,37,46,normal,1,1,0
2021-07-20 02:00:00,12,2,0,33,47,normal,2,1,0
2021-07-20 02:15:00,9,2,2,23,36,normal,2,1,0
2021-07-20 02:30:00,12,1,0,33,46,normal,2,1,0
2021-07-20 02:45:00,11,0,0,34,45,normal,2,1,0
2021-07-20 03:00:00,12,2,2,22,38,normal,3,1,0
2021-07-20 03:15:00,6,0,1,26,33,normal,3,1,0
2021-07-20 03:30:00,9,0,1,37,47,normal,3,1,0
2021-07-20 03:45:00,6,0,0,21,27,normal,3,1,0
2021-07-20 04:00:00,75,0,0,54,129,high,4,1,0
2021-07-20 04:15:00,60,9,2,50,121,high,4,1,0
2021-07-20 04:30:00,57,1,0,44,102,normal,4,1,0
2021-07-20 04:45:00,64,10,5,26,105,normal,4,1,0
2021-07-20 05:00:00,73,6,0,53,132,high,5,1,0
2021-07-20 05:15:00,62,6,4,39,111,normal,5,1,0
2021-07-20 05:30:00,80,2,5,25,112,normal,5,1,0
2021-07-20 05:45:00,25,6,5,40,76,normal,5,1,0
2021-07-20 06:00:00,73,6,3,43,125,high,6,1,0
2021-07-20 06:15:00,78,0,3,53,134,high,6,1,0
2021-07-20 06:30:00,32,6,4,27,69,normal,6,1,0
2021-07-20 06:45:00,57,5,1,49,112,high,6,1,0
2021-07-20 07:00:00,36,2,3,60,101,normal,7,1,0
2021-07-20 07:15:00,49,5,5,26,85,normal,7,1,0
2021-07-20 07:30:00,70,9,0,28,107,normal,7,1,0
2021-07-20 07:45:00,65,6,4,44,119,high,7,1,0
2021-07-20 08:00:00,53,8,0,40,101,normal,8,1,0
2021-07-20 08:15:00,38,7,1,35,81,normal,8,1,0
2021-07-20 08:30:00,68,10,5,55,138,high,8,1,0
2021-07-20 08:45:00,69,7,3,25,104,normal,8,1,0
2021-07-20 09:00:00,136,49,19,10,214,heavy,9,1,0
2021-07-20 09:15:00,128,21,6,5,160,normal,9,1,0
2021-07-20 09:30:00,138,37,15,7,197,heavy,9,1,0
2021-07-20 09:45:00,142,34,9,10,195,heavy,9,1,0
2021-07-20 10:00:00,109,23,19,8,159,normal,10,1,0
2021-07-20 10:15:00,103,24,16,10,153,normal,10,1,0
2021-07-20 10:30:00,140,34,6,7,187,heavy,10,1,0
2021-07-20 10:45:00,100,24,8,5,137,normal,10,1,0
2021-07-20 11:00:00,128,24,20,7,179,heavy,11,1,0
2021-07-20 11:15:00,124,26,16,5,171,heavy,11,1,0
2021-07-20 11:30:00,150,44,13,7,214,heavy,11,1,0
2021-07-20 11:45:00,146,21,12,5,184,heavy,11,1,0
2021-07-20 12:00:00,146,50,13,9,218,heavy,12,1,0
2021-07-20 12:15:00,121,38,19,9,187,heavy,12,1,0
2021-07-20 12:30:00,150,42,20,5,217,heavy,12,1,0
2021-07-20 12:45:00,101,22,10,10,143,normal,12,1,0
2021-07-20 13:00:00,127,22,9,7,165,normal,13,1,0
2021-07-20 13:15:00,118,31,13,10,172,heavy,13,1,0
2021-07-20 13:30:00,106,47,12,9,174,heavy,13,1,0
2021-07-20 13:45:00,136,33,16,5,190,heavy,13,1,0
2021-07-20 14:00:00,114,25,20,7,166,normal,14,1,0
2021-07-20 14:15:00,135,33,8,9,185,heavy,14,1,0
2021-07-20 14:30:00,125,33,12,10,180,heavy,14,1,0
2021-07-20 14:45:00,150,45,20,9,224,heavy,14,1,0
2021-07-20 15:00:00,85,14,2,9,110,low,15,1,0
2021-07-20 15:15:00,62,8,8,15,93,low,15,1,0
2021-07-20 15:30:00,68,9,15,15,107,low,15,1,0
2021-07-20 15:45:00,54,6,7,16,83,low,15,1,0
2021-07-20 16:00:00,70,5,7,14,96,low,16,1,0
2021-07-20 16:15:00,77,8,10,6,101,low,16,1,0
2021-07-20 16:30:00,90,6,15,17,128,normal,16,1,0
2021-07-20 16:45:00,74,13,0,16,103,low,16,1,0
2021-07-20 17:00:00,74,9,2,11,96,low,17,1,0
2021-07-20 17:15:00,62,5,2,20,89,normal,17,1,0
2021-07-20 17:30:00,66,12,8,16,102,low,17,1,0
2021-07-20 17:45:00,80,5,11,13,109,low,17,1,0
2021-07-20 18:00:00,75,13,15,12,115,normal,18,1,0
2021-07-20 18:15:00,77,12,9,20,118,normal,18,1,0
2021-07-20 18:30:00,84,10,3,15,112,normal,18,1,0
2021-07-20 18:45:00,52,7,2,19,80,normal,18,1,0
2021-07-20 19:00:00,32,2,0,32,66,normal,19,1,0
2021-07-20 19:15:00,37,4,5,33,79,normal,19,1,0
2021-07-20 19:30:00,39,1,5,29,74,normal,19,1,0
2021-07-20 19:45:00,34,1,4,35,74,normal,19,1,0
2021-07-20 20:00:00,43,3,2,41,89,normal,20,1,0
2021-07-20 20:15:00,22,1,4,43,70,normal,20,1,0
2021-07-20 20:30:00,43,4,1,27,75,normal,20,1,0
2021-07-20 20:45:00,46,1,0,35,82,normal,20,1,0
2021-07-20 21:00:00,42,2,5,42,91,normal,21,1,0
2021-07-20 21:15:00,20,5,3,39,67,normal,21,1,0
2021-07-20 21:30:00,40,5,3,26,74,normal,21,1,0
2021-07-20 21:45:00,5,0,2,39,46,normal,21,1,0
2021-07-20 22:00:00,13,2,0,20,35,normal,22,1,0
2021-07-20 22:15:00,13,2,0,24,39,normal,22,1,0
2021-07-20 22:30:00,6,0,1,22,29,normal,22,1,0
2021-07-20 22:45:00,6,1,1,34,42,normal,22,1,0
2021-07-20 23:00:00,5,0,2,27,34,normal,23,1,0
2021-07-20 23:15:00,12,1,2,25,40,normal,23,1,0
2021-07-20 23:30:00,11,1,2,35,49,normal,23,1,0
2021-07-20 23:45:00,15,2,1,34,52,normal,23,1,0
2021-07-21 00:00:00,9,2,1,36,48,normal,0,2,0
2021-07-21 00:15:00,12,0,2,32,46,normal,0,2,0
2021-07-21 00:30:00,7,2,2,23,34,normal,0,2,0
2021-07-21 00:45:00,12,1,1,33,47,normal,0,2,0
2021-07-21 01:00:00,5,0,2,30,37,normal,1,2,0
2021-07-21 01:15:00,12,1,2,27,42,normal,1,2,0
2021-07-21 01:30:00,12,1,1,30,44,normal,1,2,0
2021-07-21 01:45:00,15,1,0,34,50,normal,1,2,0
2021-07-21 02:00:00,15,2,2,31,50,normal,2,2,0
2021-07-21 02:15:00,13,0,1,29,43,normal,2,2,0
2021-07-21 02:30:00,6,2,1,27,36,normal,2,2,0
2021-07-21 02:45:00,13,0,0,30,43,normal,2,2,0
2021-07-21 03:00:00,7,1,0,22,30,normal,3,2,0
2021-07-21 03:15:00,8,1,0,28,37,normal,3,2,0
2021-07-21 03:30:00,13,0,1,27,41,normal,3,2,0
2021-07-21 03:45:00,6,1,0,33,40,normal,3,2,0
2021-07-21 04:00:00,66,2,5,13,86,low,4,2,0
2021-07-21 04:15:00,86,3,5,22,116,normal,4,2,0
2021-07-21 04:30:00,87,4,1,10,102,low,4,2,0
2021-07-21 04:45:00,68,3,7,25,103,normal,4,2,0
2021-07-21 05:00:00,51,0,2,27,80,normal,5,2,0
2021-07-21 05:15:00,70,3,3,15,91,low,5,2,0
2021-07-21 05:30:00,74,2,2,26,104,normal,5,2,0
2021-07-21 05:45:00,150,30,20,13,213,heavy,5,2,0
2021-07-21 06:00:00,89,21,18,8,136,normal,6,2,0
2021-07-21 06:15:00,114,18,23,6,161,normal,6,2,0
2021-07-21 06:30:00,81,19,18,12,130,normal,6,2,0
2021-07-21 06:45:00,94,24,10,13,141,normal,6,2,0
2021-07-21 07:00:00,136,12,22,5,175,heavy,7,2,0
2021-07-21 07:15:00,125,17,12,8,162,normal,7,2,0
2021-07-21 07:30:00,109,16,15,11,151,normal,7,2,0
2021-07-21 07:45:00,84,15,25,14,138,normal,7,2,0
2021-07-21 08:00:00,138,19,24,6,187,heavy,8,2,0
2021-07-21 08:15:00,121,17,10,14,162,normal,8,2,0
2021-07-21 08:30:00,125,27,20,14,186,heavy,8,2,0
2021-07-21 08:45:00,132,25,14,14,185,heavy,8,2,0
2021-07-21 09:00:00,62,6,23,18,109,normal,9,2,0
2021-07-21 09:15:00,40,5,5,10,60,low,9,2,0
2021-07-21 09:30:00,61,14,23,15,113,normal,9,2,0
2021-07-21 09:45:00,36,6,24,20,86,normal,9,2,0
2021-07-21 10:00:00,80,8,18,5,111,normal,10,2,0
2021-07-21 10:15:00,52,5,15,12,84,low,10,2,0
2021-07-21 10:30:00,80,9,19,17,125,normal,10,2,0
2021-07-21 10:45:00,69,9,1,25,104,normal,10,2,0
2021-07-21 11:00:00,21,9,1,26,57,normal,11,2,0
2021-07-21 11:15:00,42,8,3,27,80,normal,11,2,0
2021-07-21 11:30:00,55,10,4,30,99,normal,11,2,0
2021-07-21 11:45:00,61,10,3,31,105,normal,11,2,0
2021-07-21 12:00:00,70,3,7,33,113,high,12,2,0
2021-07-21 12:15:00,56,4,13,34,107,normal,12,2,0
2021-07-21 12:30:00,50,2,13,33,98,normal,12,2,0
2021-07-21 12:45:00,24,5,11,27,67,normal,12,2,0
2021-07-21 13:00:00,65,6,14,27,112,normal,13,2,0
2021-07-21 13:15:00,74,3,32,27,136,high,13,2,0
2021-07-21 13:30:00,33,14,33,28,108,normal,13,2,0
2021-07-21 13:45:00,16,20,1,14,51,low,13,2,0
2021-07-21 14:00:00,32,9,5,30,76,normal,14,2,0
2021-07-21 14:15:00,37,13,23,12,85,normal,14,2,0
2021-07-21 14:30:00,63,5,5,30,103,normal,14,2,0
2021-07-21 14:45:00,60,12,20,17,109,normal,14,2,0
2021-07-21 15:00:00,54,18,22,26,120,normal,15,2,0
2021-07-21 15:15:00,82,10,10,17,119,normal,15,2,0
2021-07-21 15:30:00,83,19,7,17,126,normal,15,2,0
2021-07-21 15:45:00,127,8,18,10,163,normal,15,2,0
2021-07-21 16:00:00,136,12,37,18,203,heavy,16,2,0
2021-07-21 16:15:00,105,17,34,16,172,heavy,16,2,0
2021-07-21 16:30:00,133,14,37,13,197,heavy,16,2,0
2021-07-21 16:45:00,132,19,32,17,200,heavy,16,2,0
2021-07-21 17:00:00,129,7,22,19,177,heavy,17,2,0
2021-07-21 17:15:00,107,12,26,19,164,high,17,2,0
2021-07-21 17:30:00,133,16,28,17,194,heavy,17,2,0
2021-07-21 17:45:00,114,17,28,18,177,heavy,17,2,0
2021-07-21 18:00:00,134,5,27,15,181,heavy,18,2,0
2021-07-21 18:15:00,103,14,39,20,176,heavy,18,2,0
2021-07-21 18:30:00,68,20,9,22,119,normal,18,2,0
2021-07-21 18:45:00,107,10,20,35,172,heavy,18,2,0
2021-07-21 19:00:00,81,5,13,23,122,normal,19,2,0
2021-07-21 19:15:00,93,17,17,15,142,normal,19,2,0
2021-07-21 19:30:00,78,9,7,12,106,low,19,2,0
2021-07-21 19:45:00,84,16,14,28,142,normal,19,2,0
2021-07-21 20:00:00,79,5,15,16,115,normal,20,2,0
2021-07-21 20:15:00,102,16,12,17,147,normal,20,2,0
2021-07-21 20:30:00,87,7,5,11,110,low,20,2,0
2021-07-21 20:45:00,50,4,9,19,82,normal,20,2,0
2021-07-21 21:00:00,95,0,5,11,111,low,21,2,0
2021-07-21 21:15:00,65,10,8,29,112,normal,21,2,0
2021-07-21 21:30:00,55,8,18,24,105,normal,21,2,0
2021-07-21 21:45:00,13,2,2,28,45,normal,21,2,0
2021-07-21 22:00:00,6,1,1,31,39,normal,22,2,0
2021-07-21 22:15:00,10,1,2,31,44,normal,22,2,0
2021-07-21 22:30:00,13,1,1,40,55,normal,22,2,0
2021-07-21 22:45:00,14,2,2,30,48,normal,22,2,0
2021-07-21 23:00:00,6,1,0,39,46,normal,23,2,0
2021-07-21 23:15:00,15,0,2,29,46,normal,23,2,0
2021-07-21 23:30:00,8,2,2,24,36,normal,23,2,0
2021-07-21 23:45:00,8,0,2,37,47,normal,23,2,0
2021-07-22 00:00:00,11,0,1,24,36,normal,0,3,0
2021-07-22 00:15:00,8,1,1,27,37,normal,0,3,0
2021-07-22 00:30:00,6,1,1,33,41,normal,0,3,0
2021-07-22 00:45:00,5,0,2,40,47,normal,0,3,0
2021-07-22 01:00:00,8,2,1,35,46,normal,1,3,0
2021-07-22 01:15:00,14,0,0,34,48,normal,1,3,0
2021-07-22 01:30:00,14,1,1,21,37,normal,1,3,0
2021-07-22 01:45:00,6,2,2,38,48,normal,1,3,0
2021-07-22 02:00:00,8,2,2,36,48,normal,2,3,0
2021-07-22 02:15:00,6,1,1,21,29,normal,2,3,0
2021-07-22 02:30:00,6,0,2,40,48,normal,2,3,0
2021-07-22 02:45:00,15,1,1,37,54,normal,2,3,0
2021-07-22 03:00:00,15,0,1,36,52,normal,3,3,0
2021-07-22 03:15:00,10,2,2,31,45,normal,3,3,0
2021-07-22 03:30:00,8,1,2,38,49,normal,3,3,0
2021-07-22 03:45:00,10,0,1,35,46,normal,3,3,0
2021-07-22 04:00:00,58,2,1,19,80,normal,4,3,0
2021-07-22 04:15:00,70,4,0,14,88,low,4,3,0
2021-07-22 04:30:00,72,8,4,18,102,low,4,3,0
2021-07-22 04:45:00,88,8,1,28,125,normal,4,3,0
2021-07-22 05:00:00,57,10,4,26,97,normal,5,3,0
2021-07-22 05:15:00,61,7,6,24,98,normal,5,3,0
2021-07-22 05:30:00,65,6,4,27,102,normal,5,3,0
2021-07-22 05:45:00,131,30,19,5,185,heavy,5,3,0
2021-07-22 06:00:00,117,21,21,11,170,heavy,6,3,0
2021-07-22 06:15:00,145,26,14,9,194,heavy,6,3,0
2021-07-22 06:30:00,85,16,16,6,123,normal,6,3,0
2021-07-22 06:45:00,92,19,24,5,140,normal,6,3,0
2021-07-22 07:00:00,130,19,13,9,171,heavy,7,3,0
2021-07-22 07:15:00,84,12,19,15,130,normal,7,3,0
2021-07-22 07:30:00,115,17,19,13,164,normal,7,3,0
2021-07-22 07:45:00,119,17,15,12,163,normal,7,3,0
2021-07-22 08:00:00,99,20,14,14,147,normal,8,3,0
2021-07-22 08:15:00,102,30,24,6,162,normal,8,3,0
2021-07-22 08:30:00,86,29,10,5,130,normal,8,3,0
2021-07-22 08:45:00,128,25,13,10,176,heavy,8,3,0
2021-07-22 09:00:00,40,12,20,12,84,normal,9,3,0
2021-07-22 09:15:00,56,7,15,12,90,low,9,3,0
2021-07-22 09:30:00,46,9,10,15,80,low,9,3,0
2021-07-22 09:45:00,49,6,11,14,80,low,9,3,0
2021-07-22 10:00:00,62,6,19,15,102,normal,10,3,0
2021-07-22 10:15:00,42,6,16,7,71,normal,10,3,0
2021-07-22 10:30:00,45,11,5,20,81,normal,10,3,0
2021-07-22 10:45:00,21,0,5,27,53,normal,10,3,0
2021-07-22 11:00:00,38,7,4,26,75,normal,11,3,0
2021-07-22 11:15:00,25,10,12,27,74,normal,11,3,0
2021-07-22 11:30:00,36,0,8,28,72,normal,11,3,0
2021-07-22 11:45:00,41,7,7,30,85,normal,11,3,0
2021-07-22 12:00:00,64,0,1,26,91,normal,12,3,0
2021-07-22 12:15:00,62,3,6,29,100,normal,12,3,0
2021-07-22 12:30:00,66,10,13,35,124,high,12,3,0
2021-07-22 12:45:00,34,5,7,26,72,normal,12,3,0
2021-07-22 13:00:00,84,3,0,12,99,low,13,3,0
2021-07-22 13:15:00,18,2,30,10,60,normal,13,3,0
2021-07-22 13:30:00,40,9,17,25,91,normal,13,3,0
2021-07-22 13:45:00,68,18,13,24,123,normal,13,3,0
2021-07-22 14:00:00,56,18,22,21,117,normal,14,3,0
2021-07-22 14:15:00,28,4,29,17,78,normal,14,3,0
2021-07-22 14:30:00,18,0,27,12,57,normal,14,3,0
2021-07-22 14:45:00,77,16,33,16,142,high,14,3,0
2021-07-22 15:00:00,67,8,32,11,118,high,15,3,0
2021-07-22 15:15:00,33,9,33,24,99,normal,15,3,0
2021-07-22 15:30:00,77,6,9,18,110,low,15,3,0
2021-07-22 15:45:00,104,5,14,15,138,normal,15,3,0
2021-07-22 16:00:00,130,17,27,10,184,heavy,16,3,0
2021-07-22 16:15:00,149,17,11,19,196,heavy,16,3,0
2021-07-22 16:30:00,132,20,39,15,206,heavy,16,3,0
2021-07-22 16:45:00,147,24,34,18,223,normal,16,3,0
2021-07-22 17:00:00,111,11,14,14,150,normal,17,3,0
2021-07-22 17:15:00,136,19,37,14,206,heavy,17,3,0
2021-07-22 17:30:00,120,5,34,18,177,heavy,17,3,0
2021-07-22 17:45:00,126,16,15,20,177,heavy,17,3,0
2021-07-22 18:00:00,125,5,34,18,182,heavy,18,3,0
2021-07-22 18:15:00,128,6,13,19,166,normal,18,3,0
2021-07-22 18:30:00,99,14,5,30,148,normal,18,3,0
2021-07-22 18:45:00,107,20,6,20,153,normal,18,3,0
2021-07-22 19:00:00,104,3,12,20,139,normal,19,3,0
2021-07-22 19:15:00,61,8,17,10,96,normal,19,3,0
2021-07-22 19:30:00,78,10,13,23,124,normal,19,3,0
2021-07-22 19:45:00,51,4,8,11,74,low,19,3,0
2021-07-22 20:00:00,84,3,20,16,123,normal,20,3,0
2021-07-22 20:15:00,99,1,17,12,129,normal,20,3,0
2021-07-22 20:30:00,88,20,15,35,158,high,20,3,0
2021-07-22 20:45:00,97,4,13,10,124,normal,20,3,0
2021-07-22 21:00:00,94,3,5,33,135,high,21,3,0
2021-07-22 21:15:00,68,1,13,32,114,high,21,3,0
2021-07-22 21:30:00,73,9,19,27,128,normal,21,3,0
2021-07-22 21:45:00,10,2,1,28,41,normal,21,3,0
2021-07-22 22:00:00,7,1,1,39,48,normal,22,3,0
2021-07-22 22:15:00,6,1,2,36,45,normal,22,3,0
2021-07-22 22:30:00,15,1,1,26,43,normal,22,3,0
2021-07-22 22:45:00,8,0,2,39,49,normal,22,3,0
2021-07-22 23:00:00,8,1,1,22,32,normal,23,3,0
2021-07-22 23:15:00,5,0,0,28,33,normal,23,3,0
2021-07-22 23:30:00,5,2,0,29,36,normal,23,3,0
2021-07-22 23:45:00,11,2,1,35,49,normal,23,3,0
2021-07-23 00:00:00,15,1,0,37,53,normal,0,4,0
2021-07-23 00:15:00,11,0,0,23,34,normal,0,4,0
2021-07-23 00:30:00,7,1,2,22,32,normal,0,4,0
2021-07-23 00:45:00,14,1,0,36,51,normal,0,4,0
2021-07-23 01:00:00,12,2,2,36,52,normal,1,4,0
2021-07-23 01:15:00,6,1,1,38,46,normal,1,4,0
2021-07-23 01:30:00,8,2,1,34,45,normal,1,4,0
2021-07-23 01:45:00,14,0,2,32,48,normal,1,4,0
2021-07-23 02:00:00,6,1,1,21,29,normal,2,4,0
2021-07-23 02:15:00,13,1,2,36,52,normal,2,4,0
2021-07-23 02:30:00,9,2,0,39,50,normal,2,4,0
2021-07-23 02:45:00,6,1,1,37,45,normal,2,4,0
2021-07-23 03:00:00,8,2,1,27,38,normal,3,4,0
2021-07-23 03:15:00,7,1,2,23,33,normal,3,4,0
2021-07-23 03:30:00,5,1,1,21,28,normal,3,4,0
2021-07-23 03:45:00,5,2,1,35,43,normal,3,4,0
2021-07-23 04:00:00,63,10,5,13,91,low,4,4,0
2021-07-23 04:15:00,72,3,2,13,90,low,4,4,0
2021-07-23 04:30:00,56,5,7,24,92,normal,4,4,0
2021-07-23 04:45:00,83,0,6,14,103,low,4,4,0
2021-07-23 05:00:00,88,0,2,15,105,low,5,4,0
2021-07-23 05:15:00,55,9,2,14,80,low,5,4,0
2021-07-23 05:30:00,86,1,4,11,102,low,5,4,0
2021-07-23 05:45:00,81,25,12,5,123,normal,5,4,0
2021-07-23 06:00:00,104,18,14,9,145,normal,6,4,0
2021-07-23 06:15:00,101,30,22,15,168,heavy,6,4,0
2021-07-23 06:30:00,123,30,20,8,181,heavy,6,4,0
2021-07-23 06:45:00,94,30,24,8,156,normal,6,4,0
2021-07-23 07:00:00,142,10,16,8,176,heavy,7,4,0
2021-07-23 07:15:00,108,11,22,8,149,normal,7,4,0
2021-07-23 07:30:00,100,25,19,5,149,normal,7,4,0
2021-07-23 07:45:00,84,25,24,5,138,normal,7,4,0
2021-07-23 08:00:00,125,19,23,7,174,heavy,8,4,0
2021-07-23 08:15:00,111,27,25,5,168,heavy,8,4,0
2021-07-23 08:30:00,110,21,23,5,159,normal,8,4,0
2021-07-23 08:45:00,94,26,20,15,155,normal,8,4,0
2021-07-23 09:00:00,55,10,5,8,78,low,9,4,0
2021-07-23 09:15:00,78,11,7,16,112,normal,9,4,0
2021-07-23 09:30:00,50,11,13,15,89,low,9,4,0
2021-07-23 09:45:00,63,14,27,14,118,high,9,4,0
2021-07-23 10:00:00,76,11,9,17,113,normal,10,4,0
2021-07-23 10:15:00,56,6,26,5,93,normal,10,4,0
2021-07-23 10:30:00,32,13,8,11,64,low,10,4,0
2021-07-23 10:45:00,47,7,8,29,91,normal,10,4,0
2021-07-23 11:00:00,30,9,0,31,70,normal,11,4,0
2021-07-23 11:15:00,46,2,4,31,83,normal,11,4,0
2021-07-23 11:30:00,52,2,5,29,88,normal,11,4,0
2021-07-23 11:45:00,20,3,12,29,64,normal,11,4,0
2021-07-23 12:00:00,47,2,10,28,87,normal,12,4,0
2021-07-23 12:15:00,28,10,11,34,83,normal,12,4,0
2021-07-23 12:30:00,54,2,11,26,93,normal,12,4,0
2021-07-23 12:45:00,20,6,1,34,61,normal,12,4,0
2021-07-23 13:00:00,53,13,7,15,88,low,13,4,0
2021-07-23 13:15:00,30,5,31,18,84,normal,13,4,0
2021-07-23 13:30:00,72,15,6,10,103,low,13,4,0
2021-07-23 13:45:00,69,5,35,23,132,high,13,4,0
2021-07-23 14:00:00,38,15,8,15,76,low,14,4,0
2021-07-23 14:15:00,41,8,5,14,68,low,14,4,0
2021-07-23 14:30:00,8,8,29,30,75,normal,14,4,0
2021-07-23 14:45:00,9,20,3,27,59,normal,14,4,0
2021-07-23 15:00:00,58,9,24,18,109,normal,15,4,0
2021-07-23 15:15:00,99,10,10,10,129,normal,15,4,0
2021-07-23 15:30:00,40,18,9,20,87,normal,15,4,0
2021-07-23 15:45:00,118,9,29,18,174,heavy,15,4,0
2021-07-23 16:00:00,104,27,15,10,156,normal,16,4,0
2021-07-23 16:15:00,131,29,15,18,193,heavy,16,4,0
2021-07-23 16:30:00,128,14,22,20,184,heavy,16,4,0
2021-07-23 16:45:00,110,18,19,14,161,normal,16,4,0
2021-07-23 17:00:00,116,26,22,18,182,heavy,17,4,0
2021-07-23 17:15:00,140,26,31,16,213,heavy,17,4,0
2021-07-23 17:30:00,141,27,23,16,207,heavy,17,4,0
2021-07-23 17:45:00,147,17,20,19,203,heavy,17,4,0
2021-07-23 18:00:00,137,23,25,10,195,heavy,18,4,0
2021-07-23 18:15:00,115,18,24,20,177,heavy,18,4,0
2021-07-23 18:30:00,83,3,12,27,125,normal,18,4,0
2021-07-23 18:45:00,55,9,5,10,79,low,18,4,0
2021-07-23 19:00:00,99,16,14,35,164,high,19,4,0
2021-07-23 19:15:00,57,16,8,26,107,normal,19,4,0
2021-07-23 19:30:00,65,11,17,28,121,normal,19,4,0
2021-07-23 19:45:00,52,1,14,35,102,normal,19,4,0
2021-07-23 20:00:00,60,8,9,27,104,normal,20,4,0
2021-07-23 20:15:00,109,17,9,17,152,normal,20,4,0
2021-07-23 20:30:00,71,6,20,33,130,high,20,4,0
2021-07-23 20:45:00,105,12,17,31,165,high,20,4,0
2021-07-23 21:00:00,72,18,18,25,133,normal,21,4,0
2021-07-23 21:15:00,107,8,6,25,146,normal,21,4,0
2021-07-23 21:30:00,86,13,14,20,133,normal,21,4,0
2021-07-23 21:45:00,5,2,1,35,43,normal,21,4,0
2021-07-23 22:00:00,13,2,1,40,56,normal,22,4,0
2021-07-23 22:15:00,13,0,2,33,48,normal,22,4,0
2021-07-23 22:30:00,14,2,2,27,45,normal,22,4,0
2021-07-23 22:45:00,7,2,1,27,37,normal,22,4,0
2021-07-23 23:00:00,14,2,2,28,46,normal,23,4,0
2021-07-23 23:15:00,7,1,0,29,37,normal,23,4,0
2021-07-23 23:30:00,9,1,0,36,46,normal,23,4,0
2021-07-23 23:45:00,7,1,0,27,35,normal,23,4,0
2021-07-24 00:00:00,9,2,1,26,38,normal,0,5,0
2021-07-24 00:15:00,14,1,2,34,51,normal,0,5,0
2021-07-24 00:30:00,13,2,2,21,38,normal,0,5,0
2021-07-24 00:45:00,6,0,0,21,27,normal,0,5,0
2021-07-24 01:00:00,5,1,1,28,35,normal,1,5,0
2021-07-24 01:15:00,14,0,0,31,45,normal,1,5,0
2021-07-24 01:30:00,8,0,1,39,48,normal,1,5,0
2021-07-24 01:45:00,6,2,2,24,34,normal,1,5,0
2021-07-24 02:00:00,9,1,0,33,43,normal,2,5,0
2021-07-24 02:15:00,11,1,2,40,54,normal,2,5,0
2021-07-24 02:30:00,15,0,2,22,39,normal,2,5,0
2021-07-24 02:45:00,5,2,0,39,46,normal,2,5,0
2021-07-24 03:00:00,8,1,0,39,48,normal,3,5,0
2021-07-24 03:15:00,9,2,2,31,44,normal,3,5,0
2021-07-24 03:30:00,6,2,1,31,40,normal,3,5,0
2021-07-24 03:45:00,6,2,0,39,47,normal,3,5,0
2021-07-24 04:00:00,78,0,2,17,97,low,4,5,0
2021-07-24 04:15:00,77,7,6,28,118,normal,4,5,0
2021-07-24 04:30:00,72,3,2,29,106,normal,4,5,0
2021-07-24 04:45:00,87,2,3,21,113,normal,4,5,0
2021-07-24 05:00:00,50,5,2,17,74,low,5,5,0
2021-07-24 05:15:00,79,9,5,14,107,low,5,5,0
2021-07-24 05:30:00,58,1,5,20,84,normal,5,5,0
2021-07-24 05:45:00,94,12,16,8,130,normal,5,5,0
2021-07-24 06:00:00,114,23,23,9,169,heavy,6,5,0
2021-07-24 06:15:00,94,24,23,6,147,normal,6,5,0
2021-07-24 06:30:00,137,14,13,13,177,heavy,6,5,0
2021-07-24 06:45:00,80,17,24,10,131,normal,6,5,0
2021-07-24 07:00:00,90,14,10,9,123,normal,7,5,0
2021-07-24 07:15:00,105,10,14,15,144,normal,7,5,0
2021-07-24 07:30:00,104,17,23,5,149,normal,7,5,0
2021-07-24 07:45:00,135,30,17,10,192,heavy,7,5,0
2021-07-24 08:00:00,118,25,18,9,170,heavy,8,5,0
2021-07-24 08:15:00,96,13,21,6,136,normal,8,5,0
2021-07-24 08:30:00,142,13,11,10,176,heavy,8,5,0
2021-07-24 08:45:00,128,30,15,14,187,heavy,8,5,0
2021-07-24 09:00:00,80,11,22,9,122,normal,9,5,0
2021-07-24 09:15:00,79,13,21,15,128,normal,9,5,0
2021-07-24 09:30:00,34,5,29,8,76,normal,9,5,0
2021-07-24 09:45:00,58,14,5,5,82,low,9,5,0
2021-07-24 10:00:00,42,6,23,17,88,normal,10,5,0
2021-07-24 10:15:00,63,9,19,18,109,normal,10,5,0
2021-07-24 10:30:00,62,9,18,12,101,normal,10,5,0
2021-07-24 10:45:00,44,7,11,32,94,normal,10,5,0
2021-07-24 11:00:00,49,4,5,29,87,normal,11,5,0
2021-07-24 11:15:00,67,10,1,33,111,normal,11,5,0
2021-07-24 11:30:00,68,5,0,34,107,normal,11,5,0
2021-07-24 11:45:00,23,5,10,32,70,normal,11,5,0
2021-07-24 12:00:00,69,5,2,33,109,normal,12,5,0
2021-07-24 12:15:00,37,9,2,34,82,normal,12,5,0
2021-07-24 12:30:00,24,1,6,30,61,normal,12,5,0
2021-07-24 12:45:00,60,1,4,29,94,normal,12,5,0
2021-07-24 13:00:00,59,10,29,18,116,high,13,5,0
2021-07-24 13:15:00,69,4,20,14,107,normal,13,5,0
2021-07-24 13:30:00,7,11,1,12,31,low,13,5,0
2021-07-24 13:45:00,20,13,16,10,59,normal,13,5,0
2021-07-24 14:00:00,61,16,1,14,92,low,14,5,0
2021-07-24 14:15:00,42,17,11,30,100,normal,14,5,0
2021-07-24 14:30:00,28,11,32,14,85,normal,14,5,0
2021-07-24 14:45:00,30,14,29,23,96,normal,14,5,0
2021-07-24 15:00:00,36,1,24,21,82,normal,15,5,0
2021-07-24 15:15:00,82,4,9,24,119,normal,15,5,0
2021-07-24 15:30:00,72,2,27,16,117,high,15,5,0
2021-07-24 15:45:00,119,28,17,18,182,heavy,15,5,0
2021-07-24 16:00:00,124,26,26,15,191,heavy,16,5,0
2021-07-24 16:15:00,123,27,23,13,186,heavy,16,5,0
2021-07-24 16:30:00,129,20,32,20,201,heavy,16,5,0
2021-07-24 16:45:00,143,6,38,13,200,heavy,16,5,0
2021-07-24 17:00:00,109,9,28,19,165,high,17,5,0
2021-07-24 17:15:00,119,29,25,11,184,heavy,17,5,0
2021-07-24 17:30:00,120,19,16,16,171,heavy,17,5,0
2021-07-24 17:45:00,133,24,17,18,192,heavy,17,5,0
2021-07-24 18:00:00,132,23,29,13,197,heavy,18,5,0
2021-07-24 18:15:00,102,11,15,18,146,normal,18,5,0
2021-07-24 18:30:00,73,8,10,21,112,normal,18,5,0
2021-07-24 18:45:00,57,17,13,21,108,normal,18,5,0
2021-07-24 19:00:00,94,17,7,17,135,normal,19,5,0
2021-07-24 19:15:00,75,18,17,29,139,normal,19,5,0
2021-07-24 19:30:00,58,15,17,16,106,normal,19,5,0
2021-07-24 19:45:00,67,18,11,23,119,normal,19,5,0
2021-07-24 20:00:00,59,14,9,10,92,low,20,5,0
2021-07-24 20:15:00,78,4,11,17,110,low,20,5,0
2021-07-24 20:30:00,106,13,18,29,166,normal,20,5,0
2021-07-24 20:45:00,56,20,6,32,114,high,20,5,0
2021-07-24 21:00:00,59,0,11,35,105,normal,21,5,0
2021-07-24 21:15:00,75,19,13,32,139,high,21,5,0
2021-07-24 21:30:00,85,6,5,21,117,normal,21,5,0
2021-07-24 21:45:00,14,2,2,22,40,normal,21,5,0
2021-07-24 22:00:00,8,2,0,22,32,normal,22,5,0
2021-07-24 22:15:00,15,2,0,20,37,normal,22,5,0
2021-07-24 22:30:00,8,1,1,38,48,normal,22,5,0
2021-07-24 22:45:00,14,2,0,23,39,normal,22,5,0
2021-07-24 23:00:00,15,1,2,35,53,normal,23,5,0
2021-07-24 23:15:00,14,2,1,31,48,normal,23,5,0
2021-07-24 23:30:00,9,1,0,32,42,normal,23,5,0
2021-07-24 23:45:00,12,1,0,24,37,normal,23,5,0
2021-07-25 00:00:00,11,1,2,29,43,normal,0,6,1
2021-07-25 00:15:00,7,0,1,27,35,normal,0,6,1
2021-07-25 00:30:00,14,0,2,35,51,normal,0,6,1
2021-07-25 00:45:00,10,1,1,38,50,normal,0,6,1
2021-07-25 01:00:00,10,1,0,27,38,normal,1,6,1
2021-07-25 01:15:00,13,0,1,34,48,normal,1,6,1
2021-07-25 01:30:00,13,1,1,20,35,normal,1,6,1
2021-07-25 01:45:00,15,1,0,32,48,normal,1,6,1
2021-07-25 02:00:00,7,0,0,32,39,normal,2,6,1
2021-07-25 02:15:00,13,0,2,37,52,normal,2,6,1
2021-07-25 02:30:00,8,0,0,39,47,normal,2,6,1
2021-07-25 02:45:00,11,1,2,37,51,normal,2,6,1
2021-07-25 03:00:00,11,0,0,37,48,normal,3,6,1
2021-07-25 03:15:00,10,1,2,26,39,normal,3,6,1
2021-07-25 03:30:00,15,1,1,36,53,normal,3,6,1
2021-07-25 03:45:00,9,0,2,34,45,normal,3,6,1
2021-07-25 04:00:00,60,3,6,23,92,normal,4,6,1
2021-07-25 04:15:00,51,7,3,22,83,normal,4,6,1
2021-07-25 04:30:00,60,7,2,27,96,normal,4,6,1
2021-07-25 04:45:00,65,0,3,25,93,normal,4,6,1
2021-07-25 05:00:00,66,4,1,21,92,normal,5,6,1
2021-07-25 05:15:00,63,3,5,30,101,normal,5,6,1
2021-07-25 05:30:00,72,7,2,20,101,normal,5,6,1
2021-07-25 05:45:00,124,16,21,8,169,heavy,5,6,1
2021-07-25 06:00:00,106,17,22,14,159,normal,6,6,1
2021-07-25 06:15:00,91,24,10,15,140,normal,6,6,1
2021-07-25 06:30:00,120,10,18,10,158,normal,6,6,1
2021-07-25 06:45:00,147,20,25,8,200,heavy,6,6,1
2021-07-25 07:00:00,126,30,19,8,183,heavy,7,6,1
2021-07-25 07:15:00,102,19,22,9,152,normal,7,6,1
2021-07-25 07:30:00,87,15,25,14,141,normal,7,6,1
2021-07-25 07:45:00,118,24,17,15,174,heavy,7,6,1
2021-07-25 08:00:00,144,18,16,5,183,heavy,8,6,1
2021-07-25 08:15:00,85,12,23,7,127,normal,8,6,1
2021-07-25 08:30:00,81,23,19,12,135,normal,8,6,1
2021-07-25 08:45:00,121,16,25,9,171,heavy,8,6,1
2021-07-25 09:00:00,36,14,17,6,73,normal,9,6,1
2021-07-25 09:15:00,80,15,24,11,130,normal,9,6,1
2021-07-25 09:30:00,53,12,22,8,95,normal,9,6,1
2021-07-25 09:45:00,74,7,8,20,109,normal,9,6,1
2021-07-25 10:00:00,53,11,17,13,94,normal,10,6,1
2021-07-25 10:15:00,56,6,10,9,81,low,10,6,1
2021-07-25 10:30:00,66,14,18,13,111,normal,10,6,1
2021-07-25 10:45:00,68,10,5,31,114,high,10,6,1
2021-07-25 11:00:00,24,1,10,29,64,normal,11,6,1
2021-07-25 11:15:00,52,4,10,31,97,normal,11,6,1
2021-07-25 11:30:00,35,5,12,34,86,normal,11,6,1
2021-07-25 11:45:00,47,1,5,33,86,normal,11,6,1
2021-07-25 12:00:00,36,6,2,35,79,normal,12,6,1
2021-07-25 12:15:00,61,7,5,26,99,normal,12,6,1
2021-07-25 12:30:00,57,10,2,35,104,normal,12,6,1
2021-07-25 12:45:00,64,10,9,29,112,normal,12,6,1
2021-07-25 13:00:00,31,16,23,10,80,normal,13,6,1
2021-07-25 13:15:00,91,2,0,11,104,low,13,6,1
2021-07-25 13:30:00,16,12,26,24,78,normal,13,6,1
2021-07-25 13:45:00,58,18,13,25,114,normal,13,6,1
2021-07-25 14:00:00,86,16,12,16,130,normal,14,6,1
2021-07-25 14:15:00,81,8,20,12,121,normal,14,6,1
2021-07-25 14:30:00,6,9,14,29,58,normal,14,6,1
2021-07-25 14:45:00,26,0,9,19,54,normal,14,6,1
2021-07-25 15:00:00,23,15,7,12,57,low,15,6,1
2021-07-25 15:15:00,79,5,15,13,112,normal,15,6,1
2021-07-25 15:30:00,11,7,10,29,57,normal,15,6,1
2021-07-25 15:45:00,134,22,29,11,196,heavy,15,6,1
2021-07-25 16:00:00,128,23,24,16,191,heavy,16,6,1
2021-07-25 16:15:00,106,22,19,18,165,normal,16,6,1
2021-07-25 16:30:00,124,11,30,18,183,heavy,16,6,1
2021-07-25 16:45:00,134,10,13,19,176,heavy,16,6,1
2021-07-25 17:00:00,125,17,10,16,168,heavy,17,6,1
2021-07-25 17:15:00,147,18,13,11,189,heavy,17,6,1
2021-07-25 17:30:00,100,10,20,16,146,normal,17,6,1
2021-07-25 17:45:00,146,17,25,11,199,heavy,17,6,1
2021-07-25 18:00:00,142,15,34,10,201,heavy,18,6,1
2021-07-25 18:15:00,130,24,23,10,187,heavy,18,6,1
2021-07-25 18:30:00,94,15,15,32,156,high,18,6,1
2021-07-25 18:45:00,104,7,6,19,136,normal,18,6,1
2021-07-25 19:00:00,93,10,19,26,148,normal,19,6,1
2021-07-25 19:15:00,51,8,13,17,89,low,19,6,1
2021-07-25 19:30:00,97,7,7,26,137,normal,19,6,1
2021-07-25 19:45:00,93,16,16,28,153,normal,19,6,1
2021-07-25 20:00:00,105,17,17,12,151,normal,20,6,1
2021-07-25 20:15:00,66,12,20,31,129,high,20,6,1
2021-07-25 20:30:00,56,16,20,28,120,normal,20,6,1
2021-07-25 20:45:00,109,20,8,13,150,normal,20,6,1
2021-07-25 21:00:00,64,8,14,20,106,normal,21,6,1
2021-07-25 21:15:00,83,6,6,35,130,high,21,6,1
2021-07-25 21:30:00,107,16,14,26,163,normal,21,6,1
2021-07-25 21:45:00,5,1,0,28,34,normal,21,6,1
2021-07-25 22:00:00,5,2,1,20,28,normal,22,6,1
2021-07-25 22:15:00,12,1,2,38,53,normal,22,6,1
2021-07-25 22:30:00,6,0,1,24,31,normal,22,6,1
2021-07-25 22:45:00,5,1,2,21,29,normal,22,6,1
2021-07-25 23:00:00,15,2,1,31,49,normal,23,6,1
2021-07-25 23:15:00,5,0,0,31,36,normal,23,6,1
2021-07-25 23:30:00,8,0,1,29,38,normal,23,6,1
2021-07-25 23:45:00,12,1,1,36,50,normal,23,6,1
2021-07-26 00:00:00,14,1,2,36,53,normal,0,0,0
2021-07-26 00:15:00,11,2,2,26,41,normal,0,0,0
2021-07-26 00:30:00,8,2,2,29,41,normal,0,0,0
2021-07-26 00:45:00,10,1,2,36,49,normal,0,0,0
2021-07-26 01:00:00,12,1,1,30,44,normal,1,0,0
2021-07-26 01:15:00,6,1,0,25,32,normal,1,0,0
2021-07-26 01:30:00,7,1,1,21,30,normal,1,0,0
2021-07-26 01:45:00,5,2,2,20,29,normal,1,0,0
2021-07-26 02:00:00,9,2,0,21,32,normal,2,0,0
2021-07-26 02:15:00,5,1,2,35,43,normal,2,0,0
2021-07-26 02:30:00,14,0,2,28,44,normal,2,0,0
2021-07-26 02:45:00,12,1,1,39,53,normal,2,0,0
2021-07-26 03:00:00,7,0,0,29,36,normal,3,0,0
2021-07-26 03:15:00,10,2,0,22,34,normal,3,0,0
2021-07-26 03:30:00,13,1,1,22,37,normal,3,0,0
2021-07-26 03:45:00,15,1,1,39,56,normal,3,0,0
2021-07-26 04:00:00,79,3,1,14,97,low,4,0,0
2021-07-26 04:15:00,58,3,2,18,81,low,4,0,0
2021-07-26 04:30:00,60,8,5,23,96,normal,4,0,0
2021-07-26 04:45:00,89,1,0,29,119,normal,4,0,0
2021-07-26 05:00:00,64,4,0,12,80,low,5,0,0
2021-07-26 05:15:00,62,5,3,26,96,normal,5,0,0
2021-07-26 05:30:00,79,7,7,11,104,low,5,0,0
2021-07-26 05:45:00,92,12,19,8,131,normal,5,0,0
2021-07-26 06:00:00,111,27,12,13,163,normal,6,0,0
2021-07-26 06:15:00,105,25,24,11,165,normal,6,0,0
2021-07-26 06:30:00,84,26,12,11,133,normal,6,0,0
2021-07-26 06:45:00,130,19,20,11,180,heavy,6,0,0
2021-07-26 07:00:00,107,16,16,9,148,normal,7,0,0
2021-07-26 07:15:00,130,15,11,15,171,heavy,7,0,0
2021-07-26 07:30:00,139,28,17,5,189,heavy,7,0,0
2021-07-26 07:45:00,91,17,25,14,147,normal,7,0,0
2021-07-26 08:00:00,139,22,16,5,182,heavy,8,0,0
2021-07-26 08:15:00,141,11,19,7,178,heavy,8,0,0
2021-07-26 08:30:00,116,29,14,12,171,heavy,8,0,0
2021-07-26 08:45:00,80,17,20,13,130,normal,8,0,0
2021-07-26 09:00:00,59,10,23,19,111,normal,9,0,0
2021-07-26 09:15:00,76,15,25,5,121,normal,9,0,0
2021-07-26 09:30:00,42,10,15,7,74,low,9,0,0
2021-07-26 09:45:00,31,5,27,10,73,normal,9,0,0
2021-07-26 10:00:00,40,12,26,11,89,normal,10,0,0
2021-07-26 10:15:00,72,15,7,19,113,normal,10,0,0
2021-07-26 10:30:00,37,8,15,15,75,low,10,0,0
2021-07-26 10:45:00,54,6,0,27,87,normal,10,0,0
2021-07-26 11:00:00,21,0,1,25,47,normal,11,0,0
2021-07-26 11:15:00,70,9,6,30,115,normal,11,0,0
2021-07-26 11:30:00,38,3,2,33,76,normal,11,0,0
2021-07-26 11:45:00,23,0,1,32,56,normal,11,0,0
2021-07-26 12:00:00,38,5,11,33,87,normal,12,0,0
2021-07-26 12:15:00,57,9,1,31,98,normal,12,0,0
2021-07-26 12:30:00,20,3,3,27,53,normal,12,0,0
2021-07-26 12:45:00,42,6,9,33,90,normal,12,0,0
2021-07-26 13:00:00,47,11,21,15,94,normal,13,0,0
2021-07-26 13:15:00,67,8,22,22,119,normal,13,0,0
2021-07-26 13:30:00,70,8,28,13,119,high,13,0,0
2021-07-26 13:45:00,53,7,32,11,103,normal,13,0,0
2021-07-26 14:00:00,14,19,25,30,88,normal,14,0,0
2021-07-26 14:15:00,85,16,26,26,153,high,14,0,0
2021-07-26 14:30:00,84,11,34,14,143,high,14,0,0
2021-07-26 14:45:00,59,14,33,12,118,high,14,0,0
2021-07-26 15:00:00,94,3,12,14,123,normal,15,0,0
2021-07-26 15:15:00,81,18,25,12,136,normal,15,0,0
2021-07-26 15:30:00,91,12,10,25,138,normal,15,0,0
2021-07-26 15:45:00,107,23,13,11,154,normal,15,0,0
2021-07-26 16:00:00,137,20,30,15,202,heavy,16,0,0
2021-07-26 16:15:00,121,14,32,10,177,heavy,16,0,0
2021-07-26 16:30:00,115,26,33,19,193,heavy,16,0,0
2021-07-26 16:45:00,133,25,19,12,189,heavy,16,0,0
2021-07-26 17:00:00,110,10,29,17,166,high,17,0,0
2021-07-26 17:15:00,110,20,24,17,171,heavy,17,0,0
2021-07-26 17:30:00,111,26,14,15,166,normal,17,0,0
2021-07-26 17:45:00,113,20,38,17,188,heavy,17,0,0
2021-07-26 18:00:00,134,13,29,15,191,heavy,18,0,0
2021-07-26 18:15:00,148,14,21,19,202,heavy,18,0,0
2021-07-26 18:30:00,92,15,18,18,143,normal,18,0,0
2021-07-26 18:45:00,71,2,17,10,100,normal,18,0,0
2021-07-26 19:00:00,61,0,17,25,103,normal,19,0,0
2021-07-26 19:15:00,85,6,11,25,127,normal,19,0,0
2021-07-26 19:30:00,79,11,8,16,114,normal,19,0,0
2021-07-26 19:45:00,80,17,11,17,125,normal,19,0,0
2021-07-26 20:00:00,95,5,7,22,129,normal,20,0,0
2021-07-26 20:15:00,108,1,15,25,149,normal,20,0,0
2021-07-26 20:30:00,55,20,11,25,111,normal,20,0,0
2021-07-26 20:45:00,56,8,19,27,110,normal,20,0,0
2021-07-26 21:00:00,57,14,6,34,111,normal,21,0,0
2021-07-26 21:15:00,90,11,10,27,138,normal,21,0,0
2021-07-26 21:30:00,109,20,6,18,153,normal,21,0,0
2021-07-26 21:45:00,11,2,2,39,54,normal,21,0,0
2021-07-26 22:00:00,13,1,1,25,40,normal,22,0,0
2021-07-26 22:15:00,5,2,1,26,34,normal,22,0,0
2021-07-26 22:30:00,5,1,1,33,40,normal,22,0,0
2021-07-26 22:45:00,7,2,0,37,46,normal,22,0,0
2021-07-26 23:00:00,10,2,1,32,45,normal,23,0,0
2021-07-26 23:15:00,11,0,0,26,37,normal,23,0,0
2021-07-26 23:30:00,10,0,1,37,48,normal,23,0,0
2021-07-26 23:45:00,13,1,1,21,36,normal,23,0,0
2021-07-27 00:00:00,5,2,2,32,41,normal,0,1,0
2021-07-27 00:15:00,14,1,1,33,49,normal,0,1,0
2021-07-27 00:30:00,10,0,0,30,40,normal,0,1,0
2021-07-27 00:45:00,15,0,1,38,54,normal,0,1,0
2021-07-27 01:00:00,11,2,0,34,47,normal,1,1,0
2021-07-27 01:15:00,8,2,0,39,49,normal,1,1,0
2021-07-27 01:30:00,8,2,1,40,51,normal,1,1,0
2021-07-27 01:45:00,10,1,2,33,46,normal,1,1,0
2021-07-27 02:00:00,13,1,2,37,53,normal,2,1,0
2021-07-27 02:15:00,5,1,0,38,44,normal,2,1,0
2021-07-27 02:30:00,10,1,1,30,42,normal,2,1,0
2021-07-27 02:45:00,6,1,2,23,32,normal,2,1,0
2021-07-27 03:00:00,6,2,2,22,32,normal,3,1,0
2021-07-27 03:15:00,6,2,0,30,38,normal,3,1,0
2021-07-27 03:30:00,9,2,0,37,48,normal,3,1,0
2021-07-27 03:45:00,11,2,2,34,49,normal,3,1,0
2021-07-27 04:00:00,31,0,4,57,92,normal,4,1,0
2021-07-27 04:15:00,29,2,4,37,72,normal,4,1,0
2021-07-27 04:30:00,76,0,5,40,121,high,4,1,0
2021-07-27 04:45:00,51,6,5,57,119,high,4,1,0
2021-07-27 05:00:00,69,1,0,51,121,high,5,1,0
2021-07-27 05:15:00,42,7,2,47,98,normal,5,1,0
2021-07-27 05:30:00,42,10,1,47,100,normal,5,1,0
2021-07-27 05:45:00,38,8,2,57,105,normal,5,1,0
2021-07-27 06:00:00,25,9,3,39,76,normal,6,1,0
2021-07-27 06:15:00,72,0,4,36,112,high,6,1,0
2021-07-27 06:30:00,78,8,5,37,128,high,6,1,0
2021-07-27 06:45:00,45,7,0,35,87,normal,6,1,0
2021-07-27 07:00:00,75,6,2,42,125,high,7,1,0
2021-07-27 07:15:00,77,7,1,57,142,high,7,1,0
2021-07-27 07:30:00,34,3,2,47,86,normal,7,1,0
2021-07-27 07:45:00,49,4,2,58,113,high,7,1,0
2021-07-27 08:00:00,40,4,2,57,103,normal,8,1,0
2021-07-27 08:15:00,44,9,5,56,114,high,8,1,0
2021-07-27 08:30:00,70,0,2,26,98,normal,8,1,0
2021-07-27 08:45:00,63,7,0,52,122,high,8,1,0
2021-07-27 09:00:00,126,21,7,6,160,normal,9,1,0
2021-07-27 09:15:00,117,38,11,9,175,heavy,9,1,0
2021-07-27 09:30:00,101,41,17,9,168,heavy,9,1,0
2021-07-27 09:45:00,125,35,19,7,186,heavy,9,1,0
2021-07-27 10:00:00,147,43,10,7,207,heavy,10,1,0
2021-07-27 10:15:00,140,22,18,5,185,heavy,10,1,0
2021-07-27 10:30:00,142,44,6,6,198,heavy,10,1,0
2021-07-27 10:45:00,147,45,8,10,210,heavy,10,1,0
2021-07-27 11:00:00,137,26,14,8,185,heavy,11,1,0
2021-07-27 11:15:00,129,40,13,5,187,heavy,11,1,0
2021-07-27 11:30:00,131,30,9,8,178,heavy,11,1,0
2021-07-27 11:45:00,107,40,6,6,159,normal,11,1,0
2021-07-27 12:00:00,102,37,16,7,162,normal,12,1,0
2021-07-27 12:15:00,122,46,15,8,191,heavy,12,1,0
2021-07-27 12:30:00,116,30,15,7,168,heavy,12,1,0
2021-07-27 12:45:00,136,28,20,9,193,heavy,12,1,0
2021-07-27 13:00:00,138,34,15,10,197,heavy,13,1,0
2021-07-27 13:15:00,131,21,9,9,170,heavy,13,1,0
2021-07-27 13:30:00,129,39,16,5,189,heavy,13,1,0
2021-07-27 13:45:00,118,50,18,5,191,heavy,13,1,0
2021-07-27 14:00:00,140,40,8,6,194,heavy,14,1,0
2021-07-27 14:15:00,137,29,10,9,185,heavy,14,1,0
2021-07-27 14:30:00,121,46,5,6,178,heavy,14,1,0
2021-07-27 14:45:00,120,25,10,6,161,normal,14,1,0
2021-07-27 15:00:00,72,10,13,17,112,normal,15,1,0
2021-07-27 15:15:00,83,11,9,16,119,normal,15,1,0
2021-07-27 15:30:00,67,6,12,19,104,normal,15,1,0
2021-07-27 15:45:00,75,8,7,8,98,low,15,1,0
2021-07-27 16:00:00,60,10,6,5,81,low,16,1,0
2021-07-27 16:15:00,57,13,2,12,84,low,16,1,0
2021-07-27 16:30:00,77,13,7,12,109,low,16,1,0
2021-07-27 16:45:00,64,11,0,9,84,low,16,1,0
2021-07-27 17:00:00,85,12,12,19,128,normal,17,1,0
2021-07-27 17:15:00,88,5,2,5,100,low,17,1,0
2021-07-27 17:30:00,83,14,4,18,119,normal,17,1,0
2021-07-27 17:45:00,64,6,1,13,84,low,17,1,0
2021-07-27 18:00:00,62,9,0,18,89,low,18,1,0
2021-07-27 18:15:00,69,8,0,15,92,low,18,1,0
2021-07-27 18:30:00,84,15,5,18,122,normal,18,1,0
2021-07-27 18:45:00,70,6,9,8,93,low,18,1,0
2021-07-27 19:00:00,30,0,1,30,61,normal,19,1,0
2021-07-27 19:15:00,29,3,3,30,65,normal,19,1,0
2021-07-27 19:30:00,27,0,1,33,61,normal,19,1,0
2021-07-27 19:45:00,41,3,3,40,87,normal,19,1,0
2021-07-27 20:00:00,29,3,1,35,68,normal,20,1,0
2021-07-27 20:15:00,38,0,1,28,67,normal,20,1,0
2021-07-27 20:30:00,29,2,1,27,59,normal,20,1,0
2021-07-27 20:45:00,39,4,0,36,79,normal,20,1,0
2021-07-27 21:00:00,27,1,5,31,64,normal,21,1,0
2021-07-27 21:15:00,42,5,5,26,78,normal,21,1,0
2021-07-27 21:30:00,31,1,3,38,73,normal,21,1,0
2021-07-27 21:45:00,7,0,0,35,42,normal,21,1,0
2021-07-27 22:00:00,13,0,1,40,54,normal,22,1,0
2021-07-27 22:15:00,11,2,2,25,40,normal,22,1,0
2021-07-27 22:30:00,11,0,0,31,42,normal,22,1,0
2021-07-27 22:45:00,6,2,2,23,33,normal,22,1,0
2021-07-27 23:00:00,5,2,2,26,35,normal,23,1,0
2021-07-27 23:15:00,13,1,2,26,42,normal,23,1,0
2021-07-27 23:30:00,13,1,2,39,55,normal,23,1,0
2021-07-27 23:45:00,14,2,2,28,46,normal,23,1,0
2021-07-28 00:00:00,5,0,2,39,46,normal,0,2,0
2021-07-28 00:15:00,5,1,1,40,47,normal,0,2,0
2021-07-28 00:30:00,13,2,1,38,54,normal,0,2,0
2021-07-28 00:45:00,9,1,0,29,39,normal,0,2,0
2021-07-28 01:00:00,11,0,1,27,39,normal,1,2,0
2021-07-28 01:15:00,8,0,2,33,43,normal,1,2,0
2021-07-28 01:30:00,9,0,2,40,51,normal,1,2,0
2021-07-28 01:45:00,12,1,0,37,50,normal,1,2,0
2021-07-28 02:00:00,7,2,2,23,34,normal,2,2,0
2021-07-28 02:15:00,14,1,1,29,45,normal,2,2,0
2021-07-28 02:30:00,13,1,2,38,54,normal,2,2,0
2021-07-28 02:45:00,11,2,2,37,52,normal,2,2,0
2021-07-28 03:00:00,10,2,2,26,40,normal,3,2,0
2021-07-28 03:15:00,12,0,2,21,35,normal,3,2,0
2021-07-28 03:30:00,12,2,1,21,36,normal,3,2,0
2021-07-28 03:45:00,6,2,1,38,47,normal,3,2,0
2021-07-28 04:00:00,72,6,1,25,104,normal,4,2,0
2021-07-28 04:15:00,77,5,6,20,108,normal,4,2,0
2021-07-28 04:30:00,89,10,0,16,115,normal,4,2,0
2021-07-28 04:45:00,86,1,6,28,121,normal,4,2,0
2021-07-28 05:00:00,64,1,0,27,92,normal,5,2,0
2021-07-28 05:15:00,55,3,1,27,86,normal,5,2,0
2021-07-28 05:30:00,59,0,6,16,81,low,5,2,0
2021-07-28 05:45:00,135,13,24,6,178,heavy,5,2,0
2021-07-28 06:00:00,138,21,19,10,188,heavy,6,2,0
2021-07-28 06:15:00,80,10,17,13,120,normal,6,2,0
2021-07-28 06:30:00,148,24,14,10,196,heavy,6,2,0
2021-07-28 06:45:00,84,25,21,10,140,normal,6,2,0
2021-07-28 07:00:00,103,19,15,6,143,normal,7,2,0
2021-07-28 07:15:00,119,13,10,9,151,normal,7,2,0
2021-07-28 07:30:00,110,16,21,8,155,normal,7,2,0
2021-07-28 07:45:00,130,18,20,13,181,heavy,7,2,0
2021-07-28 08:00:00,105,27,23,10,165,normal,8,2,0
2021-07-28 08:15:00,103,30,22,12,167,normal,8,2,0
2021-07-28 08:30:00,150,12,16,10,188,heavy,8,2,0
2021-07-28 08:45:00,132,15,17,14,178,heavy,8,2,0
2021-07-28 09:00:00,47,6,15,9,77,low,9,2,0
2021-07-28 09:15:00,71,10,6,10,97,low,9,2,0
2021-07-28 09:30:00,49,10,12,8,79,low,9,2,0
2021-07-28 09:45:00,43,6,21,5,75,normal,9,2,0
2021-07-28 10:00:00,74,15,29,15,133,high,10,2,0
2021-07-28 10:15:00,30,6,26,18,80,normal,10,2,0
2021-07-28 10:30:00,38,15,17,15,85,normal,10,2,0
2021-07-28 10:45:00,59,2,8,25,94,normal,10,2,0
2021-07-28 11:00:00,51,8,5,25,89,normal,11,2,0
2021-07-28 11:15:00,26,9,11,29,75,normal,11,2,0
2021-07-28 11:30:00,55,7,8,33,103,normal,11,2,0
2021-07-28 11:45:00,43,4,0,32,79,normal,11,2,0
2021-07-28 12:00:00,64,1,7,35,107,normal,12,2,0
2021-07-28 12:15:00,63,8,13,27,111,normal,12,2,0
2021-07-28 12:30:00,42,8,3,26,79,normal,12,2,0
2021-07-28 12:45:00,30,7,10,32,79,normal,12,2,0
2021-07-28 13:00:00,13,20,1,20,54,normal,13,2,0
2021-07-28 13:15:00,59,19,16,23,117,normal,13,2,0
2021-07-28 13:30:00,57,14,21,19,111,normal,13,2,0
2021-07-28 13:45:00,74,11,23,19,127,normal,13,2,0
2021-07-28 14:00:00,33,3,27,23,86,normal,14,2,0
2021-07-28 14:15:00,7,6,12,20,45,normal,14,2,0
2021-07-28 14:30:00,38,7,1,13,59,low,14,2,0
2021-07-28 14:45:00,6,9,10,27,52,normal,14,2,0
2021-07-28 15:00:00,54,6,18,23,101,normal,15,2,0
2021-07-28 15:15:00,45,16,28,18,107,normal,15,2,0
2021-07-28 15:30:00,44,3,0,23,70,normal,15,2,0
2021-07-28 15:45:00,144,21,10,19,194,heavy,15,2,0
2021-07-28 16:00:00,144,24,26,14,208,heavy,16,2,0
2021-07-28 16:15:00,112,26,38,12,188,heavy,16,2,0
2021-07-28 16:30:00,106,9,31,11,157,high,16,2,0
2021-07-28 16:45:00,149,27,33,16,225,heavy,16,2,0
2021-07-28 17:00:00,120,30,17,19,186,heavy,17,2,0
2021-07-28 17:15:00,133,15,10,10,168,heavy,17,2,0
2021-07-28 17:30:00,108,14,38,19,179,heavy,17,2,0
2021-07-28 17:45:00,141,24,11,19,195,heavy,17,2,0
2021-07-28 18:00:00,127,15,21,17,180,heavy,18,2,0
2021-07-28 18:15:00,134,20,38,20,212,heavy,18,2,0
2021-07-28 18:30:00,95,16,15,24,150,normal,18,2,0
2021-07-28 18:45:00,71,4,14,30,119,normal,18,2,0
2021-07-28 19:00:00,70,7,7,10,94,low,19,2,0
2021-07-28 19:15:00,55,13,10,33,111,normal,19,2,0
2021-07-28 19:30:00,74,19,12,35,140,high,19,2,0
2021-07-28 19:45:00,57,4,15,29,105,normal,19,2,0
2021-07-28 20:00:00,59,11,5,21,96,normal,20,2,0
2021-07-28 20:15:00,85,8,14,15,122,normal,20,2,0
2021-07-28 20:30:00,74,20,17,24,135,normal,20,2,0
2021-07-28 20:45:00,88,19,7,27,141,normal,20,2,0
2021-07-28 21:00:00,64,18,13,17,112,normal,21,2,0
2021-07-28 21:15:00,80,18,14,11,123,normal,21,2,0
2021-07-28 21:30:00,108,7,11,25,151,normal,21,2,0
2021-07-28 21:45:00,14,1,0,28,43,normal,21,2,0
2021-07-28 22:00:00,7,1,1,33,42,normal,22,2,0
2021-07-28 22:15:00,5,1,2,31,39,normal,22,2,0
2021-07-28 22:30:00,11,2,0,36,49,normal,22,2,0
2021-07-28 22:45:00,14,2,1,40,57,normal,22,2,0
2021-07-28 23:00:00,6,0,1,21,28,normal,23,2,0
2021-07-28 23:15:00,7,0,2,36,45,normal,23,2,0
2021-07-28 23:30:00,12,2,1,20,35,normal,23,2,0
2021-07-28 23:45:00,8,2,2,39,51,normal,23,2,0
2021-07-29 00:00:00,5,1,0,35,41,normal,0,3,0
2021-07-29 00:15:00,5,2,1,21,29,normal,0,3,0
2021-07-29 00:30:00,10,0,2,33,45,normal,0,3,0
2021-07-29 00:45:00,12,0,0,35,47,normal,0,3,0
2021-07-29 01:00:00,11,0,2,37,50,normal,1,3,0
2021-07-29 01:15:00,6,0,0,29,35,normal,1,3,0
2021-07-29 01:30:00,15,2,1,38,56,normal,1,3,0
2021-07-29 01:45:00,13,1,2,20,36,normal,1,3,0
2021-07-29 02:00:00,11,2,2,39,54,normal,2,3,0
2021-07-29 02:15:00,6,1,0,39,46,normal,2,3,0
2021-07-29 02:30:00,6,0,1,28,35,normal,2,3,0
2021-07-29 02:45:00,15,2,1,37,55,normal,2,3,0
2021-07-29 03:00:00,11,2,2,24,39,normal,3,3,0
2021-07-29 03:15:00,5,0,0,21,26,normal,3,3,0
2021-07-29 03:30:00,8,0,0,20,28,normal,3,3,0
2021-07-29 03:45:00,8,1,2,29,40,normal,3,3,0
2021-07-29 04:00:00,54,8,7,16,85,low,4,3,0
2021-07-29 04:15:00,64,0,1,25,90,normal,4,3,0
2021-07-29 04:30:00,55,2,6,24,87,normal,4,3,0
2021-07-29 04:45:00,86,4,5,20,115,normal,4,3,0
2021-07-29 05:00:00,51,10,3,28,92,normal,5,3,0
2021-07-29 05:15:00,81,8,5,12,106,low,5,3,0
2021-07-29 05:30:00,73,1,3,23,100,normal,5,3,0
2021-07-29 05:45:00,104,29,19,13,165,normal,5,3,0
2021-07-29 06:00:00,122,17,21,9,169,heavy,6,3,0
2021-07-29 06:15:00,94,21,15,7,137,normal,6,3,0
2021-07-29 06:30:00,141,30,22,11,204,heavy,6,3,0
2021-07-29 06:45:00,93,12,25,7,137,normal,6,3,0
2021-07-29 07:00:00,123,29,13,7,172,heavy,7,3,0
2021-07-29 07:15:00,131,27,19,15,192,heavy,7,3,0
2021-07-29 07:30:00,138,25,20,14,197,heavy,7,3,0
2021-07-29 07:45:00,148,20,14,11,193,heavy,7,3,0
2021-07-29 08:00:00,93,12,14,13,132,normal,8,3,0
2021-07-29 08:15:00,125,22,12,12,171,heavy,8,3,0
2021-07-29 08:30:00,109,26,16,9,160,normal,8,3,0
2021-07-29 08:45:00,99,25,15,12,151,normal,8,3,0
2021-07-29 09:00:00,78,6,29,14,127,high,9,3,0
2021-07-29 09:15:00,63,6,21,9,99,normal,9,3,0
2021-07-29 09:30:00,36,11,25,8,80,normal,9,3,0
2021-07-29 09:45:00,69,5,23,16,113,normal,9,3,0
2021-07-29 10:00:00,67,13,15,17,112,normal,10,3,0
2021-07-29 10:15:00,34,12,28,11,85,normal,10,3,0
2021-07-29 10:30:00,71,6,12,19,108,normal,10,3,0
2021-07-29 10:45:00,22,9,0,31,62,normal,10,3,0
2021-07-29 11:00:00,54,4,10,35,103,normal,11,3,0
2021-07-29 11:15:00,27,8,13,35,83,normal,11,3,0
2021-07-29 11:30:00,36,2,7,27,72,normal,11,3,0
2021-07-29 11:45:00,29,9,13,28,79,normal,11,3,0
2021-07-29 12:00:00,65,3,12,25,105,normal,12,3,0
2021-07-29 12:15:00,66,5,7,35,113,high,12,3,0
2021-07-29 12:30:00,23,4,5,30,62,normal,12,3,0
2021-07-29 12:45:00,42,10,2,25,79,normal,12,3,0
2021-07-29 13:00:00,55,5,33,20,113,high,13,3,0
2021-07-29 13:15:00,18,5,15,21,59,normal,13,3,0
2021-07-29 13:30:00,22,13,17,22,74,normal,13,3,0
2021-07-29 13:45:00,59,18,18,23,118,normal,13,3,0
2021-07-29 14:00:00,63,16,3,13,95,low,14,3,0
2021-07-29 14:15:00,66,3,25,12,106,normal,14,3,0
2021-07-29 14:30:00,75,4,3,15,97,low,14,3,0
2021-07-29 14:45:00,92,7,35,25,159,high,14,3,0
2021-07-29 15:00:00,40,14,16,28,98,normal,15,3,0
2021-07-29 15:15:00,39,2,8,19,68,normal,15,3,0
2021-07-29 15:30:00,43,11,16,20,90,normal,15,3,0
2021-07-29 15:45:00,128,26,25,12,191,heavy,15,3,0
2021-07-29 16:00:00,150,24,30,12,216,heavy,16,3,0
2021-07-29 16:15:00,108,6,37,18,169,heavy,16,3,0
2021-07-29 16:30:00,111,17,40,18,186,heavy,16,3,0
2021-07-29 16:45:00,112,24,39,16,191,heavy,16,3,0
2021-07-29 17:00:00,140,10,38,18,206,heavy,17,3,0
2021-07-29 17:15:00,144,13,15,14,186,heavy,17,3,0
2021-07-29 17:30:00,127,17,24,17,185,heavy,17,3,0
2021-07-29 17:45:00,100,8,13,11,132,normal,17,3,0
2021-07-29 18:00:00,138,9,16,20,183,heavy,18,3,0
2021-07-29 18:15:00,108,10,21,16,155,normal,18,3,0
2021-07-29 18:30:00,82,8,19,12,121,normal,18,3,0
2021-07-29 18:45:00,107,19,6,17,149,normal,18,3,0
2021-07-29 19:00:00,73,1,10,32,116,high,19,3,0
2021-07-29 19:15:00,54,4,13,34,105,normal,19,3,0
2021-07-29 19:30:00,68,10,20,13,111,normal,19,3,0
2021-07-29 19:45:00,70,9,13,25,117,normal,19,3,0
2021-07-29 20:00:00,58,20,17,16,111,normal,20,3,0
2021-07-29 20:15:00,99,12,13,16,140,normal,20,3,0
2021-07-29 20:30:00,100,14,16,28,158,normal,20,3,0
2021-07-29 20:45:00,68,14,16,20,118,normal,20,3,0
2021-07-29 21:00:00,106,11,17,27,161,normal,21,3,0
2021-07-29 21:15:00,83,13,9,34,139,high,21,3,0
2021-07-29 21:30:00,66,14,8,24,112,normal,21,3,0
2021-07-29 21:45:00,6,1,2,29,38,normal,21,3,0
2021-07-29 22:00:00,11,0,0,27,38,normal,22,3,0
2021-07-29 22:15:00,11,2,1,29,43,normal,22,3,0
2021-07-29 22:30:00,8,2,1,28,39,normal,22,3,0
2021-07-29 22:45:00,13,2,1,23,39,normal,22,3,0
2021-07-29 23:00:00,7,1,1,20,29,normal,23,3,0
2021-07-29 23:15:00,7,2,1,35,45,normal,23,3,0
2021-07-29 23:30:00,5,2,0,25,32,normal,23,3,0
2021-07-29 23:45:00,10,2,0,40,52,normal,23,3,0
2021-07-30 00:00:00,14,2,0,33,49,normal,0,4,0
2021-07-30 00:15:00,12,1,0,38,51,normal,0,4,0
2021-07-30 00:30:00,7,1,0,27,35,normal,0,4,0
2021-07-30 00:45:00,15,0,1,28,44,normal,0,4,0
2021-07-30 01:00:00,12,2,1,31,46,normal,1,4,0
2021-07-30 01:15:00,15,0,2,21,38,normal,1,4,0
2021-07-30 01:30:00,12,1,0,36,49,normal,1,4,0
2021-07-30 01:45:00,9,1,1,26,37,normal,1,4,0
2021-07-30 02:00:00,7,2,1,39,49,normal,2,4,0
2021-07-30 02:15:00,13,2,0,40,55,normal,2,4,0
2021-07-30 02:30:00,14,1,1,27,43,normal,2,4,0
2021-07-30 02:45:00,9,0,2,24,35,normal,2,4,0
2021-07-30 03:00:00,13,0,0,38,51,normal,3,4,0
2021-07-30 03:15:00,15,2,0,32,49,normal,3,4,0
2021-07-30 03:30:00,6,0,2,24,32,normal,3,4,0
2021-07-30 03:45:00,7,0,2,31,40,normal,3,4,0
2021-07-30 04:00:00,84,8,2,12,106,low,4,4,0
2021-07-30 04:15:00,71,0,4,23,98,normal,4,4,0
2021-07-30 04:30:00,80,8,4,21,113,normal,4,4,0
2021-07-30 04:45:00,77,10,7,27,121,normal,4,4,0
2021-07-30 05:00:00,86,9,1,29,125,normal,5,4,0
2021-07-30 05:15:00,71,0,5,18,94,low,5,4,0
2021-07-30 05:30:00,78,6,2,11,97,low,5,4,0
2021-07-30 05:45:00,82,22,10,9,123,normal,5,4,0
2021-07-30 06:00:00,114,14,16,13,157,normal,6,4,0
2021-07-30 06:15:00,115,22,23,13,173,heavy,6,4,0
2021-07-30 06:30:00,81,18,12,11,122,normal,6,4,0
2021-07-30 06:45:00,145,10,23,13,191,heavy,6,4,0
2021-07-30 07:00:00,84,21,14,13,132,normal,7,4,0
2021-07-30 07:15:00,109,27,13,14,163,normal,7,4,0
2021-07-30 07:30:00,103,23,10,9,145,normal,7,4,0
2021-07-30 07:45:00,131,27,20,9,187,heavy,7,4,0
2021-07-30 08:00:00,113,29,12,15,169,heavy,8,4,0
2021-07-30 08:15:00,127,18,20,7,172,heavy,8,4,0
2021-07-30 08:30:00,125,24,17,8,174,heavy,8,4,0
2021-07-30 08:45:00,88,28,25,8,149,normal,8,4,0
2021-07-30 09:00:00,54,8,10,15,87,low,9,4,0
2021-07-30 09:15:00,78,15,19,14,126,normal,9,4,0
2021-07-30 09:30:00,39,11,16,16,82,normal,9,4,0
2021-07-30 09:45:00,56,9,26,20,111,normal,9,4,0
2021-07-30 10:00:00,32,10,19,18,79,normal,10,4,0
2021-07-30 10:15:00,70,5,18,7,100,normal,10,4,0
2021-07-30 10:30:00,55,10,30,15,110,normal,10,4,0
2021-07-30 10:45:00,66,5,6,26,103,normal,10,4,0
2021-07-30 11:00:00,26,6,1,30,63,normal,11,4,0
2021-07-30 11:15:00,50,1,13,29,93,normal,11,4,0
2021-07-30 11:30:00,52,7,1,26,86,normal,11,4,0
2021-07-30 11:45:00,23,8,13,34,78,normal,11,4,0
2021-07-30 12:00:00,59,9,11,28,107,normal,12,4,0
2021-07-30 12:15:00,43,1,6,25,75,normal,12,4,0
2021-07-30 12:30:00,21,8,4,32,65,normal,12,4,0
2021-07-30 12:45:00,23,7,9,31,70,normal,12,4,0
2021-07-30 13:00:00,51,3,7,17,78,low,13,4,0
2021-07-30 13:15:00,84,0,30,19,133,high,13,4,0
2021-07-30 13:30:00,17,19,3,10,49,low,13,4,0
2021-07-30 13:45:00,79,9,19,11,118,normal,13,4,0
2021-07-30 14:00:00,66,19,29,20,134,high,14,4,0
2021-07-30 14:15:00,6,12,29,25,72,normal,14,4,0
2021-07-30 14:30:00,61,7,25,21,114,normal,14,4,0
2021-07-30 14:45:00,68,12,5,11,96,low,14,4,0
2021-07-30 15:00:00,23,13,28,27,91,normal,15,4,0
2021-07-30 15:15:00,22,18,15,21,76,normal,15,4,0
2021-07-30 15:30:00,38,13,13,11,75,low,15,4,0
2021-07-30 15:45:00,146,14,11,17,188,heavy,15,4,0
2021-07-30 16:00:00,123,13,31,16,183,heavy,16,4,0
2021-07-30 16:15:00,132,27,33,19,211,heavy,16,4,0
2021-07-30 16:30:00,134,17,13,20,184,heavy,16,4,0
2021-07-30 16:45:00,138,7,40,11,196,heavy,16,4,0
2021-07-30 17:00:00,100,26,17,19,162,normal,17,4,0
2021-07-30 17:15:00,117,12,36,15,180,heavy,17,4,0
2021-07-30 17:30:00,142,6,28,15,191,heavy,17,4,0
2021-07-30 17:45:00,149,24,36,12,221,heavy,17,4,0
2021-07-30 18:00:00,110,14,35,11,170,heavy,18,4,0
2021-07-30 18:15:00,105,5,20,13,143,normal,18,4,0
2021-07-30 18:30:00,91,4,13,11,119,normal,18,4,0
2021-07-30 18:45:00,106,4,6,15,131,normal,18,4,0
2021-07-30 19:00:00,83,3,11,31,128,high,19,4,0
2021-07-30 19:15:00,57,0,10,29,96,normal,19,4,0
2021-07-30 19:30:00,54,15,18,22,109,normal,19,4,0
2021-07-30 19:45:00,66,9,18,32,125,high,19,4,0
2021-07-30 20:00:00,53,6,8,27,94,normal,20,4,0
2021-07-30 20:15:00,108,18,16,30,172,heavy,20,4,0
2021-07-30 20:30:00,91,15,14,28,148,normal,20,4,0
2021-07-30 20:45:00,107,17,5,20,149,normal,20,4,0
2021-07-30 21:00:00,83,9,19,14,125,normal,21,4,0
2021-07-30 21:15:00,88,6,6,15,115,normal,21,4,0
2021-07-30 21:30:00,110,1,17,23,151,normal,21,4,0
2021-07-30 21:45:00,7,2,2,27,38,normal,21,4,0
2021-07-30 22:00:00,10,2,1,22,35,normal,22,4,0
2021-07-30 22:15:00,11,1,1,24,37,normal,22,4,0
2021-07-30 22:30:00,6,1,0,25,32,normal,22,4,0
2021-07-30 22:45:00,11,1,2,21,35,normal,22,4,0
2021-07-30 23:00:00,12,1,0,36,49,normal,23,4,0
2021-07-30 23:15:00,9,1,0,31,41,normal,23,4,0
2021-07-30 23:30:00,15,0,0,38,53,normal,23,4,0
2021-07-30 23:45:00,5,0,1,21,27,normal,23,4,0
2021-07-31 00:00:00,10,0,2,27,39,normal,0,5,0
2021-07-31 00:15:00,13,2,2,28,45,normal,0,5,0
2021-07-31 00:30:00,10,0,1,21,32,normal,0,5,0
2021-07-31 00:45:00,13,2,1,32,48,normal,0,5,0
2021-07-31 01:00:00,13,1,2,31,47,normal,1,5,0
2021-07-31 01:15:00,10,2,0,37,49,normal,1,5,0
2021-07-31 01:30:00,5,2,2,34,43,normal,1,5,0
2021-07-31 01:45:00,14,0,1,21,36,normal,1,5,0
2021-07-31 02:00:00,10,1,2,39,52,normal,2,5,0
2021-07-31 02:15:00,9,0,2,40,51,normal,2,5,0
2021-07-31 02:30:00,14,0,0,31,45,normal,2,5,0
2021-07-31 02:45:00,5,2,1,29,37,normal,2,5,0
2021-07-31 03:00:00,10,2,0,22,34,normal,3,5,0
2021-07-31 03:15:00,10,2,2,34,48,normal,3,5,0
2021-07-31 03:30:00,12,2,2,29,45,normal,3,5,0
2021-07-31 03:45:00,7,2,1,32,42,normal,3,5,0
2021-07-31 04:00:00,70,5,5,29,109,normal,4,5,0
2021-07-31 04:15:00,67,5,6,19,97,normal,4,5,0
2021-07-31 04:30:00,52,6,5,14,77,low,4,5,0
2021-07-31 04:45:00,59,0,4,27,90,normal,4,5,0
2021-07-31 05:00:00,66,1,6,19,92,normal,5,5,0
2021-07-31 05:15:00,62,6,3,18,89,low,5,5,0
2021-07-31 05:30:00,72,7,5,14,98,low,5,5,0
2021-07-31 05:45:00,90,10,14,9,123,normal,5,5,0
2021-07-31 06:00:00,86,22,10,12,130,normal,6,5,0
2021-07-31 06:15:00,125,25,22,5,177,heavy,6,5,0
2021-07-31 06:30:00,81,29,24,15,149,normal,6,5,0
2021-07-31 06:45:00,150,15,22,12,199,heavy,6,5,0
2021-07-31 07:00:00,98,15,11,15,139,normal,7,5,0
2021-07-31 07:15:00,119,24,21,9,173,heavy,7,5,0
2021-07-31 07:30:00,104,23,15,6,148,normal,7,5,0
2021-07-31 07:45:00,81,15,20,11,127,normal,7,5,0
2021-07-31 08:00:00,90,26,25,7,148,normal,8,5,0
2021-07-31 08:15:00,93,26,19,6,144,normal,8,5,0
2021-07-31 08:30:00,110,25,13,9,157,normal,8,5,0
2021-07-31 08:45:00,125,16,15,10,166,normal,8,5,0
2021-07-31 09:00:00,47,10,9,9,75,low,9,5,0
2021-07-31 09:15:00,61,14,18,14,107,normal,9,5,0
2021-07-31 09:30:00,48,8,14,8,78,low,9,5,0
2021-07-31 09:45:00,42,12,6,17,77,low,9,5,0
2021-07-31 10:00:00,36,7,27,8,78,normal,10,5,0
2021-07-31 10:15:00,30,10,28,5,73,normal,10,5,0
2021-07-31 10:30:00,76,15,14,20,125,normal,10,5,0
2021-07-31 10:45:00,44,7,6,30,87,normal,10,5,0
2021-07-31 11:00:00,30,1,12,29,72,normal,11,5,0
2021-07-31 11:15:00,56,7,7,34,104,normal,11,5,0
2021-07-31 11:30:00,67,3,5,35,110,normal,11,5,0
2021-07-31 11:45:00,55,8,2,30,95,normal,11,5,0
2021-07-31 12:00:00,52,10,13,35,110,normal,12,5,0
2021-07-31 12:15:00,28,4,0,35,67,normal,12,5,0
2021-07-31 12:30:00,69,0,13,25,107,normal,12,5,0
2021-07-31 12:45:00,42,9,5,25,81,normal,12,5,0
2021-07-31 13:00:00,95,3,2,27,127,normal,13,5,0
2021-07-31 13:15:00,45,13,33,27,118,high,13,5,0
2021-07-31 13:30:00,69,5,2,15,91,low,13,5,0
2021-07-31 13:45:00,85,19,2,28,134,normal,13,5,0
2021-07-31 14:00:00,87,15,6,27,135,normal,14,5,0
2021-07-31 14:15:00,100,13,7,17,137,normal,14,5,0
2021-07-31 14:30:00,5,19,3,10,37,low,14,5,0
2021-07-31 14:45:00,50,13,12,17,92,low,14,5,0
2021-07-31 15:00:00,64,3,17,11,95,normal,15,5,0
2021-07-31 15:15:00,97,2,5,18,122,normal,15,5,0
2021-07-31 15:30:00,97,8,30,27,162,high,15,5,0
2021-07-31 15:45:00,101,13,31,19,164,high,15,5,0
2021-07-31 16:00:00,139,29,34,10,212,heavy,16,5,0
2021-07-31 16:15:00,139,18,39,17,213,heavy,16,5,0
2021-07-31 16:30:00,105,12,39,14,170,heavy,16,5,0
2021-07-31 16:45:00,101,26,25,18,170,heavy,16,5,0
2021-07-31 17:00:00,109,25,36,11,181,heavy,17,5,0
2021-07-31 17:15:00,135,19,13,16,183,heavy,17,5,0
2021-07-31 17:30:00,118,18,14,19,169,heavy,17,5,0
2021-07-31 17:45:00,102,29,36,18,185,heavy,17,5,0
2021-07-31 18:00:00,136,25,31,18,210,heavy,18,5,0
2021-07-31 18:15:00,112,22,26,13,173,heavy,18,5,0
2021-07-31 18:30:00,105,17,16,16,154,normal,18,5,0
2021-07-31 18:45:00,57,12,12,35,116,high,18,5,0
2021-07-31 19:00:00,52,19,14,34,119,high,19,5,0
2021-07-31 19:15:00,67,6,11,17,101,low,19,5,0
2021-07-31 19:30:00,64,6,12,32,114,high,19,5,0
2021-07-31 19:45:00,107,6,12,32,157,high,19,5,0
2021-07-31 20:00:00,87,7,5,11,110,low,20,5,0
2021-07-31 20:15:00,71,8,13,28,120,normal,20,5,0
2021-07-31 20:30:00,91,6,7,35,139,high,20,5,0
2021-07-31 20:45:00,82,3,16,24,125,normal,20,5,0
2021-07-31 21:00:00,98,16,8,31,153,high,21,5,0
2021-07-31 21:15:00,84,5,6,35,130,high,21,5,0
2021-07-31 21:30:00,98,18,8,18,142,normal,21,5,0
2021-07-31 21:45:00,5,1,1,28,35,normal,21,5,0
2021-07-31 22:00:00,6,2,0,31,39,normal,22,5,0
2021-07-31 22:15:00,7,1,0,31,39,normal,22,5,0
2021-07-31 22:30:00,11,1,0,30,42,normal,22,5,0
2021-07-31 22:45:00,12,1,2,26,41,normal,22,5,0
2021-07-31 23:00:00,11,0,0,34,45,normal,23,5,0
2021-07-31 23:15:00,6,2,1,29,38,normal,23,5,0
2021-07-31 23:30:00,6,0,0,36,42,normal,23,5,0
2021-07-31 23:45:00,9,1,1,38,49,normal,23,5,0
2021-08-01 00:00:00,13,2,0,30,45,normal,0,6,1
2021-08-01 00:15:00,11,1,1,39,52,normal,0,6,1
2021-08-01 00:30:00,15,0,1,34,50,normal,0,6,1
2021-08-01 00:45:00,13,1,0,37,51,normal,0,6,1
2021-08-01 01:00:00,13,0,0,32,45,normal,1,6,1
2021-08-01 01:15:00,5,1,1,27,34,normal,1,6,1
2021-08-01 01:30:00,13,1,2,27,43,normal,1,6,1
2021-08-01 01:45:00,15,1,0,27,43,normal,1,6,1
2021-08-01 02:00:00,10,1,0,22,33,normal,2,6,1
2021-08-01 02:15:00,15,2,2,39,58,normal,2,6,1
2021-08-01 02:30:00,7,2,2,30,41,normal,2,6,1
2021-08-01 02:45:00,5,0,0,35,40,normal,2,6,1
2021-08-01 03:00:00,15,1,1,37,54,normal,3,6,1
2021-08-01 03:15:00,5,0,1,22,28,normal,3,6,1
2021-08-01 03:30:00,7,2,1,23,33,normal,3,6,1
2021-08-01 03:45:00,15,1,0,28,44,normal,3,6,1
2021-08-01 04:00:00,88,1,3,17,109,low,4,6,1
2021-08-01 04:15:00,70,8,6,13,97,low,4,6,1
2021-08-01 04:30:00,71,4,5,23,103,normal,4,6,1
2021-08-01 04:45:00,72,9,1,26,108,normal,4,6,1
2021-08-01 05:00:00,59,2,0,12,73,low,5,6,1
2021-08-01 05:15:00,52,7,0,13,72,low,5,6,1
2021-08-01 05:30:00,54,7,2,30,93,normal,5,6,1
2021-08-01 05:45:00,82,30,21,10,143,normal,5,6,1
2021-08-01 06:00:00,124,27,25,15,191,heavy,6,6,1
2021-08-01 06:15:00,143,22,21,5,191,heavy,6,6,1
2021-08-01 06:30:00,107,21,15,11,154,normal,6,6,1
2021-08-01 06:45:00,95,30,24,6,155,normal,6,6,1
2021-08-01 07:00:00,106,29,23,11,169,heavy,7,6,1
2021-08-01 07:15:00,145,22,24,14,205,heavy,7,6,1
2021-08-01 07:30:00,111,17,15,12,155,normal,7,6,1
2021-08-01 07:45:00,142,13,14,6,175,heavy,7,6,1
2021-08-01 08:00:00,112,22,17,15,166,normal,8,6,1
2021-08-01 08:15:00,134,27,19,8,188,heavy,8,6,1
2021-08-01 08:30:00,86,15,23,6,130,normal,8,6,1
2021-08-01 08:45:00,103,19,15,9,146,normal,8,6,1
2021-08-01 09:00:00,55,11,25,14,105,normal,9,6,1
2021-08-01 09:15:00,62,8,21,10,101,normal,9,6,1
2021-08-01 09:30:00,41,8,5,17,71,low,9,6,1
2021-08-01 09:45:00,58,10,14,7,89,low,9,6,1
2021-08-01 10:00:00,78,14,13,7,112,normal,10,6,1
2021-08-01 10:15:00,49,12,13,12,86,low,10,6,1
2021-08-01 10:30:00,63,10,10,20,103,normal,10,6,1
2021-08-01 10:45:00,45,0,12,30,87,normal,10,6,1
2021-08-01 11:00:00,69,7,6,27,109,normal,11,6,1
2021-08-01 11:15:00,50,6,10,35,101,normal,11,6,1
2021-08-01 11:30:00,66,6,12,25,109,normal,11,6,1
2021-08-01 11:45:00,47,10,2,34,93,normal,11,6,1
2021-08-01 12:00:00,61,2,9,27,99,normal,12,6,1
2021-08-01 12:15:00,57,10,0,27,94,normal,12,6,1
2021-08-01 12:30:00,26,3,3,29,61,normal,12,6,1
2021-08-01 12:45:00,30,4,2,32,68,normal,12,6,1
2021-08-01 13:00:00,9,13,2,19,43,normal,13,6,1
2021-08-01 13:15:00,46,10,34,21,111,normal,13,6,1
2021-08-01 13:30:00,11,16,28,23,78,normal,13,6,1
2021-08-01 13:45:00,96,1,5,25,127,normal,13,6,1
2021-08-01 14:00:00,29,12,18,18,77,normal,14,6,1
2021-08-01 14:15:00,50,8,34,26,118,high,14,6,1
2021-08-01 14:30:00,85,7,5,20,117,normal,14,6,1
2021-08-01 14:45:00,77,12,22,23,134,normal,14,6,1
2021-08-01 15:00:00,16,4,2,14,36,low,15,6,1
2021-08-01 15:15:00,38,17,5,14,74,low,15,6,1
2021-08-01 15:30:00,11,10,23,17,61,normal,15,6,1
2021-08-01 15:45:00,119,18,17,14,168,heavy,15,6,1
2021-08-01 16:00:00,111,8,37,10,166,high,16,6,1
2021-08-01 16:15:00,118,10,13,16,157,normal,16,6,1
2021-08-01 16:30:00,119,13,28,13,173,heavy,16,6,1
2021-08-01 16:45:00,144,18,28,13,203,heavy,16,6,1
2021-08-01 17:00:00,133,29,14,11,187,heavy,17,6,1
2021-08-01 17:15:00,134,5,21,15,175,heavy,17,6,1
2021-08-01 17:30:00,140,20,27,13,200,heavy,17,6,1
2021-08-01 17:45:00,116,27,34,20,197,heavy,17,6,1
2021-08-01 18:00:00,121,15,19,20,175,heavy,18,6,1
2021-08-01 18:15:00,123,30,32,12,197,heavy,18,6,1
2021-08-01 18:30:00,62,0,19,34,115,high,18,6,1
2021-08-01 18:45:00,91,17,14,15,137,normal,18,6,1
2021-08-01 19:00:00,107,20,20,19,166,normal,19,6,1
2021-08-01 19:15:00,75,14,5,35,129,high,19,6,1
2021-08-01 19:30:00,96,3,10,33,142,high,19,6,1
2021-08-01 19:45:00,66,2,11,24,103,normal,19,6,1
2021-08-01 20:00:00,89,15,13,31,148,high,20,6,1
2021-08-01 20:15:00,69,13,7,22,111,normal,20,6,1
2021-08-01 20:30:00,109,16,19,13,157,normal,20,6,1
2021-08-01 20:45:00,54,0,20,11,85,normal,20,6,1
2021-08-01 21:00:00,79,0,8,25,112,normal,21,6,1
2021-08-01 21:15:00,78,17,20,11,126,normal,21,6,1
2021-08-01 21:30:00,93,0,10,18,121,normal,21,6,1
2021-08-01 21:45:00,9,1,1,36,47,normal,21,6,1
2021-08-01 22:00:00,13,0,0,29,42,normal,22,6,1
2021-08-01 22:15:00,13,2,1,28,44,normal,22,6,1
2021-08-01 22:30:00,14,0,0,40,54,normal,22,6,1
2021-08-01 22:45:00,11,1,1,35,48,normal,22,6,1
2021-08-01 23:00:00,11,2,1,38,52,normal,23,6,1
2021-08-01 23:15:00,15,1,2,35,53,normal,23,6,1
2021-08-01 23:30:00,7,1,0,38,46,normal,23,6,1
2021-08-01 23:45:00,10,0,0,32,42,normal,23,6,1
2021-08-02 00:00:00,6,2,1,35,44,normal,0,0,0
2021-08-02 00:15:00,13,2,1,33,49,normal,0,0,0
2021-08-02 00:30:00,8,0,0,39,47,normal,0,0,0
2021-08-02 00:45:00,9,0,0,35,44,normal,0,0,0
2021-08-02 01:00:00,6,2,2,35,45,normal,1,0,0
2021-08-02 01:15:00,13,2,1,25,41,normal,1,0,0
2021-08-02 01:30:00,12,0,0,33,45,normal,1,0,0
2021-08-02 01:45:00,12,1,1,33,47,normal,1,0,0
2021-08-02 02:00:00,11,2,0,20,33,normal,2,0,0
2021-08-02 02:15:00,11,2,2,27,42,normal,2,0,0
2021-08-02 02:30:00,9,1,0,26,36,normal,2,0,0
2021-08-02 02:45:00,12,2,0,33,47,normal,2,0,0
2021-08-02 03:00:00,11,0,1,40,52,normal,3,0,0
2021-08-02 03:15:00,8,2,2,23,35,normal,3,0,0
2021-08-02 03:30:00,6,2,1,32,41,normal,3,0,0
2021-08-02 03:45:00,8,1,2,31,42,normal,3,0,0
2021-08-02 04:00:00,50,9,4,12,75,low,4,0,0
2021-08-02 04:15:00,90,0,4,21,115,normal,4,0,0
2021-08-02 04:30:00,51,7,5,11,74,low,4,0,0
2021-08-02 04:45:00,83,0,4,13,100,low,4,0,0
2021-08-02 05:00:00,86,5,0,21,112,normal,5,0,0
2021-08-02 05:15:00,76,0,3,22,101,normal,5,0,0
2021-08-02 05:30:00,72,4,5,16,97,low,5,0,0
2021-08-02 05:45:00,101,20,18,13,152,normal,5,0,0
2021-08-02 06:00:00,139,13,21,8,181,heavy,6,0,0
2021-08-02 06:15:00,113,27,12,8,160,normal,6,0,0
2021-08-02 06:30:00,125,26,12,15,178,heavy,6,0,0
2021-08-02 06:45:00,130,18,17,13,178,heavy,6,0,0
2021-08-02 07:00:00,129,17,21,5,172,heavy,7,0,0
2021-08-02 07:15:00,104,28,10,8,150,normal,7,0,0
2021-08-02 07:30:00,85,27,21,13,146,normal,7,0,0
2021-08-02 07:45:00,95,12,25,15,147,normal,7,0,0
2021-08-02 08:00:00,105,20,11,8,144,normal,8,0,0
2021-08-02 08:15:00,129,27,21,9,186,heavy,8,0,0
2021-08-02 08:30:00,122,26,21,10,179,heavy,8,0,0
2021-08-02 08:45:00,80,14,22,6,122,normal,8,0,0
2021-08-02 09:00:00,67,8,25,20,120,normal,9,0,0
2021-08-02 09:15:00,74,7,17,10,108,normal,9,0,0
2021-08-02 09:30:00,30,8,25,10,73,normal,9,0,0
2021-08-02 09:45:00,58,8,23,19,108,normal,9,0,0
2021-08-02 10:00:00,57,13,10,9,89,low,10,0,0
2021-08-02 10:15:00,55,12,30,5,102,normal,10,0,0
2021-08-02 10:30:00,44,5,11,18,78,low,10,0,0
2021-08-02 10:45:00,59,5,10,31,105,normal,10,0,0
2021-08-02 11:00:00,57,1,12,28,98,normal,11,0,0
2021-08-02 11:15:00,67,6,6,29,108,normal,11,0,0
2021-08-02 11:30:00,46,6,11,35,98,normal,11,0,0
2021-08-02 11:45:00,39,5,10,27,81,normal,11,0,0
2021-08-02 12:00:00,39,8,5,32,84,normal,12,0,0
2021-08-02 12:15:00,20,4,9,31,64,normal,12,0,0
2021-08-02 12:30:00,70,1,8,25,104,normal,12,0,0
2021-08-02 12:45:00,31,8,13,25,77,normal,12,0,0
2021-08-02 13:00:00,10,4,3,18,35,low,13,0,0
2021-08-02 13:15:00,55,7,24,15,101,normal,13,0,0
2021-08-02 13:30:00,72,12,18,23,125,normal,13,0,0
2021-08-02 13:45:00,38,7,27,13,85,normal,13,0,0
2021-08-02 14:00:00,79,12,22,14,127,normal,14,0,0
2021-08-02 14:15:00,40,9,6,10,65,low,14,0,0
2021-08-02 14:30:00,28,2,1,11,42,low,14,0,0
2021-08-02 14:45:00,99,6,10,23,138,normal,14,0,0
2021-08-02 15:00:00,44,19,28,26,117,high,15,0,0
2021-08-02 15:15:00,91,0,11,25,127,normal,15,0,0
2021-08-02 15:30:00,28,15,17,20,80,normal,15,0,0
2021-08-02 15:45:00,111,27,20,20,178,heavy,15,0,0
2021-08-02 16:00:00,113,10,33,10,166,high,16,0,0
2021-08-02 16:15:00,119,27,17,17,180,heavy,16,0,0
2021-08-02 16:30:00,146,28,12,11,197,heavy,16,0,0
2021-08-02 16:45:00,127,30,20,13,190,heavy,16,0,0
2021-08-02 17:00:00,138,10,10,20,178,heavy,17,0,0
2021-08-02 17:15:00,107,27,19,18,171,heavy,17,0,0
2021-08-02 17:30:00,102,14,16,20,152,normal,17,0,0
2021-08-02 17:45:00,125,29,12,14,180,heavy,17,0,0
2021-08-02 18:00:00,112,12,30,10,164,high,18,0,0
2021-08-02 18:15:00,123,19,14,19,175,heavy,18,0,0
2021-08-02 18:30:00,106,19,7,15,147,normal,18,0,0
2021-08-02 18:45:00,76,16,13,20,125,normal,18,0,0
2021-08-02 19:00:00,65,5,6,19,95,normal,19,0,0
2021-08-02 19:15:00,59,18,8,24,109,normal,19,0,0
2021-08-02 19:30:00,99,0,5,30,134,normal,19,0,0
2021-08-02 19:45:00,74,1,8,25,108,normal,19,0,0
2021-08-02 20:00:00,105,16,15,33,169,heavy,20,0,0
2021-08-02 20:15:00,57,8,11,16,92,low,20,0,0
2021-08-02 20:30:00,100,16,13,20,149,normal,20,0,0
2021-08-02 20:45:00,91,16,16,22,145,normal,20,0,0
2021-08-02 21:00:00,71,4,15,34,124,high,21,0,0
2021-08-02 21:15:00,70,12,19,15,116,normal,21,0,0
2021-08-02 21:30:00,68,0,7,14,89,low,21,0,0
2021-08-02 21:45:00,12,1,1,30,44,normal,21,0,0
2021-08-02 22:00:00,14,1,1,35,51,normal,22,0,0
2021-08-02 22:15:00,8,0,1,25,34,normal,22,0,0
2021-08-02 22:30:00,7,2,2,20,31,normal,22,0,0
2021-08-02 22:45:00,8,0,1,30,39,normal,22,0,0
2021-08-02 23:00:00,13,0,1,30,44,normal,23,0,0
2021-08-02 23:15:00,15,1,2,30,48,normal,23,0,0
2021-08-02 23:30:00,9,1,1,32,43,normal,23,0,0
2021-08-02 23:45:00,5,1,0,36,42,normal,23,0,0
2021-08-03 00:00:00,13,1,0,37,51,normal,0,1,0
2021-08-03 00:15:00,14,0,2,30,46,normal,0,1,0
2021-08-03 00:30:00,13,1,2,26,42,normal,0,1,0
2021-08-03 00:45:00,8,0,1,32,41,normal,0,1,0
2021-08-03 01:00:00,10,0,1,37,48,normal,1,1,0
2021-08-03 01:15:00,15,1,0,27,43,normal,1,1,0
2021-08-03 01:30:00,7,2,2,40,51,normal,1,1,0
2021-08-03 01:45:00,12,0,0,32,44,normal,1,1,0
2021-08-03 02:00:00,14,1,1,21,37,normal,2,1,0
2021-08-03 02:15:00,5,1,2,30,38,normal,2,1,0
2021-08-03 02:30:00,8,1,0,24,33,normal,2,1,0
2021-08-03 02:45:00,15,0,0,27,42,normal,2,1,0
2021-08-03 03:00:00,14,1,1,26,42,normal,3,1,0
2021-08-03 03:15:00,12,1,2,36,51,normal,3,1,0
2021-08-03 03:30:00,13,1,1,25,40,normal,3,1,0
2021-08-03 03:45:00,14,2,0,38,54,normal,3,1,0
2021-08-03 04:00:00,43,8,0,28,79,normal,4,1,0
2021-08-03 04:15:00,26,1,2,34,63,normal,4,1,0
2021-08-03 04:30:00,49,1,5,32,87,normal,4,1,0
2021-08-03 04:45:00,65,9,2,53,129,high,4,1,0
2021-08-03 05:00:00,46,4,2,59,111,normal,5,1,0
2021-08-03 05:15:00,79,4,3,26,112,normal,5,1,0
2021-08-03 05:30:00,32,9,4,58,103,normal,5,1,0
2021-08-03 05:45:00,57,3,3,38,101,normal,5,1,0
2021-08-03 06:00:00,73,4,0,39,116,high,6,1,0
2021-08-03 06:15:00,29,1,0,39,69,normal,6,1,0
2021-08-03 06:30:00,79,10,1,28,118,normal,6,1,0
2021-08-03 06:45:00,59,8,5,44,116,high,6,1,0
2021-08-03 07:00:00,71,1,4,44,120,high,7,1,0
2021-08-03 07:15:00,50,10,2,56,118,high,7,1,0
2021-08-03 07:30:00,62,7,2,35,106,normal,7,1,0
2021-08-03 07:45:00,72,0,4,27,103,normal,7,1,0
2021-08-03 08:00:00,54,10,5,34,103,normal,8,1,0
2021-08-03 08:15:00,31,3,3,26,63,normal,8,1,0
2021-08-03 08:30:00,72,6,4,36,118,high,8,1,0
2021-08-03 08:45:00,68,6,1,28,103,normal,8,1,0
2021-08-03 09:00:00,116,34,5,7,162,normal,9,1,0
2021-08-03 09:15:00,149,37,14,10,210,heavy,9,1,0
2021-08-03 09:30:00,143,48,19,5,215,heavy,9,1,0
2021-08-03 09:45:00,143,21,6,6,176,heavy,9,1,0
2021-08-03 10:00:00,100,26,14,6,146,normal,10,1,0
2021-08-03 10:15:00,139,30,13,10,192,heavy,10,1,0
2021-08-03 10:30:00,103,23,6,7,139,normal,10,1,0
2021-08-03 10:45:00,136,38,13,6,193,heavy,10,1,0
2021-08-03 11:00:00,101,42,13,6,162,normal,11,1,0
2021-08-03 11:15:00,144,43,13,8,208,heavy,11,1,0
2021-08-03 11:30:00,101,34,12,7,154,normal,11,1,0
2021-08-03 11:45:00,109,31,8,8,156,normal,11,1,0
2021-08-03 12:00:00,125,22,18,8,173,heavy,12,1,0
2021-08-03 12:15:00,108,28,16,9,161,normal,12,1,0
2021-08-03 12:30:00,147,35,19,8,209,heavy,12,1,0
2021-08-03 12:45:00,128,49,7,9,193,heavy,12,1,0
2021-08-03 13:00:00,130,43,15,6,194,heavy,13,1,0
2021-08-03 13:15:00,102,23,8,6,139,normal,13,1,0
2021-08-03 13:30:00,113,38,17,10,178,heavy,13,1,0
2021-08-03 13:45:00,147,38,5,8,198,heavy,13,1,0
2021-08-03 14:00:00,109,30,7,9,155,normal,14,1,0
2021-08-03 14:15:00,123,29,16,10,178,heavy,14,1,0
2021-08-03 14:30:00,121,41,14,5,181,heavy,14,1,0
2021-08-03 14:45:00,136,46,9,10,201,heavy,14,1,0
2021-08-03 15:00:00,58,14,14,15,101,low,15,1,0
2021-08-03 15:15:00,62,6,7,12,87,low,15,1,0
2021-08-03 15:30:00,62,7,9,7,85,low,15,1,0
2021-08-03 15:45:00,55,6,2,18,81,low,15,1,0
2021-08-03 16:00:00,87,15,15,16,133,normal,16,1,0
2021-08-03 16:15:00,62,5,14,9,90,low,16,1,0
2021-08-03 16:30:00,82,5,5,5,97,low,16,1,0
2021-08-03 16:45:00,68,5,0,16,89,low,16,1,0
2021-08-03 17:00:00,66,11,9,5,91,low,17,1,0
2021-08-03 17:15:00,76,14,15,11,116,normal,17,1,0
2021-08-03 17:30:00,89,8,4,15,116,normal,17,1,0
2021-08-03 17:45:00,81,13,0,14,108,low,17,1,0
2021-08-03 18:00:00,56,5,9,17,87,low,18,1,0
2021-08-03 18:15:00,52,6,5,6,69,low,18,1,0
2021-08-03 18:30:00,80,6,14,13,113,normal,18,1,0
2021-08-03 18:45:00,81,15,11,20,127,normal,18,1,0
2021-08-03 19:00:00,37,2,4,31,74,normal,19,1,0
2021-08-03 19:15:00,24,1,3,35,63,normal,19,1,0
2021-08-03 19:30:00,26,2,4,35,67,normal,19,1,0
2021-08-03 19:45:00,28,2,2,41,73,normal,19,1,0
2021-08-03 20:00:00,49,1,5,34,89,normal,20,1,0
2021-08-03 20:15:00,38,1,2,40,81,normal,20,1,0
2021-08-03 20:30:00,20,3,4,40,67,normal,20,1,0
2021-08-03 20:45:00,28,0,3,42,73,normal,20,1,0
2021-08-03 21:00:00,27,5,1,25,58,normal,21,1,0
2021-08-03 21:15:00,28,2,4,44,78,normal,21,1,0
2021-08-03 21:30:00,21,4,5,31,61,normal,21,1,0
2021-08-03 21:45:00,5,1,2,33,41,normal,21,1,0
2021-08-03 22:00:00,7,1,0,22,30,normal,22,1,0
2021-08-03 22:15:00,13,0,2,29,44,normal,22,1,0
2021-08-03 22:30:00,15,0,1,28,44,normal,22,1,0
2021-08-03 22:45:00,15,0,1,38,54,normal,22,1,0
2021-08-03 23:00:00,15,0,0,34,49,normal,23,1,0
2021-08-03 23:15:00,13,0,1,34,48,normal,23,1,0
2021-08-03 23:30:00,11,2,1,29,43,normal,23,1,0
2021-08-03 23:45:00,13,1,2,26,42,normal,23,1,0
2021-08-04 00:00:00,15,0,1,21,37,normal,0,2,0
2021-08-04 00:15:00,6,0,2,21,29,normal,0,2,0
2021-08-04 00:30:00,12,0,2,37,51,normal,0,2,0
2021-08-04 00:45:00,6,0,2,23,31,normal,0,2,0
2021-08-04 01:00:00,12,2,0,34,48,normal,1,2,0
2021-08-04 01:15:00,8,0,1,35,44,normal,1,2,0
2021-08-04 01:30:00,6,2,0,24,32,normal,1,2,0
2021-08-04 01:45:00,14,1,1,35,51,normal,1,2,0
2021-08-04 02:00:00,14,0,1,27,42,normal,2,2,0
2021-08-04 02:15:00,14,1,1,37,53,normal,2,2,0
2021-08-04 02:30:00,11,2,2,33,48,normal,2,2,0
2021-08-04 02:45:00,8,0,1,20,29,normal,2,2,0
2021-08-04 03:00:00,9,1,2,27,39,normal,3,2,0
2021-08-04 03:15:00,8,1,1,27,37,normal,3,2,0
2021-08-04 03:30:00,6,2,1,30,39,normal,3,2,0
2021-08-04 03:45:00,7,2,2,27,38,normal,3,2,0
2021-08-04 04:00:00,50,5,4,16,75,low,4,2,0
2021-08-04 04:15:00,59,8,7,17,91,low,4,2,0
2021-08-04 04:30:00,70,8,0,24,102,normal,4,2,0
2021-08-04 04:45:00,61,6,5,12,84,low,4,2,0
2021-08-04 05:00:00,67,4,3,16,90,low,5,2,0
2021-08-04 05:15:00,63,7,0,23,93,normal,5,2,0
2021-08-04 05:30:00,53,1,1,23,78,normal,5,2,0
2021-08-04 05:45:00,106,22,17,8,153,normal,5,2,0
2021-08-04 06:00:00,114,18,24,6,162,normal,6,2,0
2021-08-04 06:15:00,103,14,14,10,141,normal,6,2,0
2021-08-04 06:30:00,118,27,10,12,167,low,6,2,0
2021-08-04 06:45:00,120,11,12,9,152,normal,6,2,0
2021-08-04 07:00:00,144,22,12,10,188,heavy,7,2,0
2021-08-04 07:15:00,123,20,21,6,170,heavy,7,2,0
2021-08-04 07:30:00,91,26,11,15,143,normal,7,2,0
2021-08-04 07:45:00,143,26,22,10,201,heavy,7,2,0
2021-08-04 08:00:00,120,13,11,5,149,normal,8,2,0
2021-08-04 08:15:00,80,13,11,5,109,low,8,2,0
2021-08-04 08:30:00,123,30,13,12,178,heavy,8,2,0
2021-08-04 08:45:00,143,25,14,12,194,heavy,8,2,0
2021-08-04 09:00:00,39,5,17,14,75,normal,9,2,0
2021-08-04 09:15:00,73,12,25,16,126,normal,9,2,0
2021-08-04 09:30:00,75,14,24,18,131,normal,9,2,0
2021-08-04 09:45:00,38,15,6,6,65,low,9,2,0
2021-08-04 10:00:00,66,6,7,16,95,low,10,2,0
2021-08-04 10:15:00,45,14,18,14,91,normal,10,2,0
2021-08-04 10:30:00,77,11,13,6,107,low,10,2,0
2021-08-04 10:45:00,58,7,2,25,92,normal,10,2,0
2021-08-04 11:00:00,61,8,7,34,110,normal,11,2,0
2021-08-04 11:15:00,46,2,0,25,73,normal,11,2,0
2021-08-04 11:30:00,55,3,4,25,87,normal,11,2,0
2021-08-04 11:45:00,36,8,3,29,76,normal,11,2,0
2021-08-04 12:00:00,52,1,8,29,90,normal,12,2,0
2021-08-04 12:15:00,32,5,4,26,67,normal,12,2,0
2021-08-04 12:30:00,38,5,7,27,77,normal,12,2,0
2021-08-04 12:45:00,24,2,12,32,70,normal,12,2,0
2021-08-04 13:00:00,90,15,24,29,158,normal,13,2,0
2021-08-04 13:15:00,17,4,4,11,36,low,13,2,0
2021-08-04 13:30:00,85,5,1,26,117,normal,13,2,0
2021-08-04 13:45:00,34,17,19,20,90,normal,13,2,0
2021-08-04 14:00:00,55,16,17,16,104,normal,14,2,0
2021-08-04 14:15:00,25,3,28,17,73,normal,14,2,0
2021-08-04 14:30:00,64,13,9,12,98,low,14,2,0
2021-08-04 14:45:00,59,14,24,21,118,normal,14,2,0
2021-08-04 15:00:00,11,3,2,14,30,low,15,2,0
2021-08-04 15:15:00,88,3,31,23,145,high,15,2,0
2021-08-04 15:30:00,100,19,23,22,164,normal,15,2,0
2021-08-04 15:45:00,144,16,25,18,203,heavy,15,2,0
2021-08-04 16:00:00,116,23,37,11,187,heavy,16,2,0
2021-08-04 16:15:00,114,6,38,11,169,heavy,16,2,0
2021-08-04 16:30:00,130,10,19,10,169,heavy,16,2,0
2021-08-04 16:45:00,144,19,18,15,196,heavy,16,2,0
2021-08-04 17:00:00,119,13,38,18,188,heavy,17,2,0
2021-08-04 17:15:00,131,6,17,12,166,normal,17,2,0
2021-08-04 17:30:00,123,18,18,12,171,heavy,17,2,0
2021-08-04 17:45:00,147,14,32,10,203,heavy,17,2,0
2021-08-04 18:00:00,114,27,32,10,183,heavy,18,2,0
2021-08-04 18:15:00,113,27,35,10,185,heavy,18,2,0
2021-08-04 18:30:00,98,8,9,14,129,normal,18,2,0
2021-08-04 18:45:00,76,3,8,13,100,low,18,2,0
2021-08-04 19:00:00,108,8,6,21,143,normal,19,2,0
2021-08-04 19:15:00,63,11,5,26,105,normal,19,2,0
2021-08-04 19:30:00,72,20,5,18,115,normal,19,2,0
2021-08-04 19:45:00,80,0,12,13,105,low,19,2,0
2021-08-04 20:00:00,59,7,14,16,96,low,20,2,0
2021-08-04 20:15:00,99,12,14,34,159,high,20,2,0
2021-08-04 20:30:00,65,16,9,14,104,low,20,2,0
2021-08-04 20:45:00,81,18,16,33,148,high,20,2,0
2021-08-04 21:00:00,103,14,11,11,139,normal,21,2,0
2021-08-04 21:15:00,81,18,5,17,121,normal,21,2,0
2021-08-04 21:30:00,52,9,5,34,100,normal,21,2,0
2021-08-04 21:45:00,6,0,2,40,48,normal,21,2,0
2021-08-04 22:00:00,6,2,0,40,48,normal,22,2,0
2021-08-04 22:15:00,9,1,0,22,32,normal,22,2,0
2021-08-04 22:30:00,11,1,0,26,38,normal,22,2,0
2021-08-04 22:45:00,14,2,1,39,56,normal,22,2,0
2021-08-04 23:00:00,7,1,1,30,39,normal,23,2,0
2021-08-04 23:15:00,8,2,2,35,47,normal,23,2,0
2021-08-04 23:30:00,5,2,2,33,42,normal,23,2,0
2021-08-04 23:45:00,6,1,2,23,32,normal,23,2,0
2021-08-05 00:00:00,15,0,2,32,49,normal,0,3,0
2021-08-05 00:15:00,15,0,2,29,46,normal,0,3,0
2021-08-05 00:30:00,7,2,2,33,44,normal,0,3,0
2021-08-05 00:45:00,14,2,0,33,49,normal,0,3,0
2021-08-05 01:00:00,6,1,1,38,46,normal,1,3,0
2021-08-05 01:15:00,11,0,0,26,37,normal,1,3,0
2021-08-05 01:30:00,6,2,1,34,43,normal,1,3,0
2021-08-05 01:45:00,7,0,2,22,31,normal,1,3,0
2021-08-05 02:00:00,13,2,0,24,39,normal,2,3,0
2021-08-05 02:15:00,5,2,1,33,41,normal,2,3,0
2021-08-05 02:30:00,10,0,1,40,51,normal,2,3,0
2021-08-05 02:45:00,12,1,2,26,41,normal,2,3,0
2021-08-05 03:00:00,8,0,0,28,36,normal,3,3,0
2021-08-05 03:15:00,7,0,2,36,45,normal,3,3,0
2021-08-05 03:30:00,14,0,0,32,46,normal,3,3,0
2021-08-05 03:45:00,14,2,2,39,57,normal,3,3,0
2021-08-05 04:00:00,57,6,1,30,94,normal,4,3,0
2021-08-05 04:15:00,64,4,7,15,90,low,4,3,0
2021-08-05 04:30:00,80,9,7,29,125,normal,4,3,0
2021-08-05 04:45:00,80,2,2,18,102,low,4,3,0
2021-08-05 05:00:00,78,4,0,11,93,low,5,3,0
2021-08-05 05:15:00,51,8,0,29,88,normal,5,3,0
2021-08-05 05:30:00,66,3,0,27,96,normal,5,3,0
2021-08-05 05:45:00,146,19,25,8,198,heavy,5,3,0
2021-08-05 06:00:00,104,22,15,8,149,normal,6,3,0
2021-08-05 06:15:00,137,22,14,10,183,heavy,6,3,0
2021-08-05 06:30:00,150,26,18,10,204,heavy,6,3,0
2021-08-05 06:45:00,148,15,22,8,193,heavy,6,3,0
2021-08-05 07:00:00,83,30,12,10,135,normal,7,3,0
2021-08-05 07:15:00,96,22,23,8,149,normal,7,3,0
2021-08-05 07:30:00,112,10,23,11,156,normal,7,3,0
2021-08-05 07:45:00,145,20,24,13,202,heavy,7,3,0
2021-08-05 08:00:00,86,28,19,9,142,normal,8,3,0
2021-08-05 08:15:00,127,27,17,15,186,heavy,8,3,0
2021-08-05 08:30:00,88,12,19,10,129,normal,8,3,0
2021-08-05 08:45:00,103,11,19,5,138,normal,8,3,0
2021-08-05 09:00:00,74,14,28,15,131,high,9,3,0
2021-08-05 09:15:00,42,10,20,5,77,normal,9,3,0
2021-08-05 09:30:00,55,11,20,19,105,normal,9,3,0
2021-08-05 09:45:00,71,8,28,11,118,high,9,3,0
2021-08-05 10:00:00,55,5,23,16,99,normal,10,3,0
2021-08-05 10:15:00,43,8,22,20,93,normal,10,3,0
2021-08-05 10:30:00,54,11,11,11,87,low,10,3,0
2021-08-05 10:45:00,58,9,3,32,102,normal,10,3,0
2021-08-05 11:00:00,46,1,11,35,93,normal,11,3,0
2021-08-05 11:15:00,64,6,7,30,107,normal,11,3,0
2021-08-05 11:30:00,43,5,3,31,82,normal,11,3,0
2021-08-05 11:45:00,39,10,2,33,84,normal,11,3,0
2021-08-05 12:00:00,59,2,9,33,103,normal,12,3,0
2021-08-05 12:15:00,56,5,6,33,100,normal,12,3,0
2021-08-05 12:30:00,40,5,12,26,83,normal,12,3,0
2021-08-05 12:45:00,69,4,7,26,106,normal,12,3,0
2021-08-05 13:00:00,53,2,14,12,81,low,13,3,0
2021-08-05 13:15:00,22,7,8,27,64,normal,13,3,0
2021-08-05 13:30:00,33,16,5,30,84,normal,13,3,0
2021-08-05 13:45:00,35,14,16,20,85,normal,13,3,0
2021-08-05 14:00:00,12,3,11,15,41,low,14,3,0
2021-08-05 14:15:00,83,12,8,23,126,normal,14,3,0
2021-08-05 14:30:00,39,7,11,19,76,normal,14,3,0
2021-08-05 14:45:00,44,12,25,12,93,normal,14,3,0
2021-08-05 15:00:00,57,19,11,16,103,low,15,3,0
2021-08-05 15:15:00,13,19,7,12,51,low,15,3,0
2021-08-05 15:30:00,79,17,12,13,121,normal,15,3,0
2021-08-05 15:45:00,127,20,16,17,180,heavy,15,3,0
2021-08-05 16:00:00,112,19,15,18,164,normal,16,3,0
2021-08-05 16:15:00,122,12,20,19,173,heavy,16,3,0
2021-08-05 16:30:00,141,22,29,12,204,heavy,16,3,0
2021-08-05 16:45:00,131,29,33,12,205,heavy,16,3,0
2021-08-05 17:00:00,126,6,22,15,169,heavy,17,3,0
2021-08-05 17:15:00,128,14,11,18,171,heavy,17,3,0
2021-08-05 17:30:00,137,29,36,18,220,heavy,17,3,0
2021-08-05 17:45:00,129,18,10,18,175,heavy,17,3,0
2021-08-05 18:00:00,100,30,31,20,181,heavy,18,3,0
2021-08-05 18:15:00,136,16,17,11,180,heavy,18,3,0
2021-08-05 18:30:00,94,8,14,19,135,normal,18,3,0
2021-08-05 18:45:00,86,14,13,33,146,high,18,3,0
2021-08-05 19:00:00,81,0,7,15,103,low,19,3,0
2021-08-05 19:15:00,84,1,16,19,120,normal,19,3,0
2021-08-05 19:30:00,76,11,16,17,120,normal,19,3,0
2021-08-05 19:45:00,76,11,19,17,123,normal,19,3,0
2021-08-05 20:00:00,83,10,19,18,130,normal,20,3,0
2021-08-05 20:15:00,60,2,10,18,90,low,20,3,0
2021-08-05 20:30:00,55,9,15,25,104,normal,20,3,0
2021-08-05 20:45:00,69,3,19,32,123,high,20,3,0
2021-08-05 21:00:00,52,2,9,19,82,normal,21,3,0
2021-08-05 21:15:00,74,9,15,33,131,high,21,3,0
2021-08-05 21:30:00,102,18,20,31,171,heavy,21,3,0
2021-08-05 21:45:00,9,2,2,31,44,normal,21,3,0
2021-08-05 22:00:00,14,1,1,28,44,normal,22,3,0
2021-08-05 22:15:00,8,2,2,35,47,normal,22,3,0
2021-08-05 22:30:00,14,0,0,28,42,normal,22,3,0
2021-08-05 22:45:00,6,2,2,40,50,normal,22,3,0
2021-08-05 23:00:00,12,2,1,34,49,normal,23,3,0
2021-08-05 23:15:00,15,0,1,25,41,normal,23,3,0
2021-08-05 23:30:00,13,1,2,40,56,normal,23,3,0
2021-08-05 23:45:00,9,2,2,32,45,normal,23,3,0
2021-08-06 00:00:00,9,2,0,27,38,normal,0,4,0
2021-08-06 00:15:00,14,1,0,30,45,normal,0,4,0
2021-08-06 00:30:00,15,2,0,30,47,normal,0,4,0
2021-08-06 00:45:00,7,2,0,26,35,normal,0,4,0
2021-08-06 01:00:00,5,0,2,23,30,normal,1,4,0
2021-08-06 01:15:00,9,1,0,27,37,normal,1,4,0
2021-08-06 01:30:00,6,2,2,28,38,normal,1,4,0
2021-08-06 01:45:00,7,2,1,39,49,normal,1,4,0
2021-08-06 02:00:00,6,2,1,27,36,normal,2,4,0
2021-08-06 02:15:00,6,1,1,36,44,normal,2,4,0
2021-08-06 02:30:00,10,1,2,25,38,normal,2,4,0
2021-08-06 02:45:00,12,2,0,40,54,normal,2,4,0
2021-08-06 03:00:00,10,0,1,34,45,normal,3,4,0
2021-08-06 03:15:00,8,0,1,22,31,normal,3,4,0
2021-08-06 03:30:00,10,0,2,37,49,normal,3,4,0
2021-08-06 03:45:00,12,1,2,21,36,normal,3,4,0
2021-08-06 04:00:00,73,7,2,22,104,normal,4,4,0
2021-08-06 04:15:00,59,9,4,20,92,normal,4,4,0
2021-08-06 04:30:00,52,2,5,30,89,normal,4,4,0
2021-08-06 04:45:00,63,6,3,28,100,normal,4,4,0
2021-08-06 05:00:00,77,2,5,19,103,normal,5,4,0
2021-08-06 05:15:00,58,8,7,13,86,low,5,4,0
2021-08-06 05:30:00,72,1,5,11,89,low,5,4,0
2021-08-06 05:45:00,126,14,14,8,162,normal,5,4,0
2021-08-06 06:00:00,91,29,19,15,154,normal,6,4,0
2021-08-06 06:15:00,134,18,14,6,172,heavy,6,4,0
2021-08-06 06:30:00,96,18,16,7,137,normal,6,4,0
2021-08-06 06:45:00,112,22,12,5,151,normal,6,4,0
2021-08-06 07:00:00,125,22,10,9,166,normal,7,4,0
2021-08-06 07:15:00,142,25,22,5,194,heavy,7,4,0
2021-08-06 07:30:00,102,19,13,10,144,normal,7,4,0
2021-08-06 07:45:00,89,23,19,12,143,normal,7,4,0
2021-08-06 08:00:00,119,15,17,12,163,normal,8,4,0
2021-08-06 08:15:00,137,13,19,14,183,heavy,8,4,0
2021-08-06 08:30:00,128,21,19,13,181,heavy,8,4,0
2021-08-06 08:45:00,81,20,18,15,134,normal,8,4,0
2021-08-06 09:00:00,49,15,15,5,84,low,9,4,0
2021-08-06 09:15:00,59,6,10,17,92,low,9,4,0
2021-08-06 09:30:00,69,5,26,6,106,normal,9,4,0
2021-08-06 09:45:00,72,10,7,20,109,normal,9,4,0
2021-08-06 10:00:00,44,15,16,16,91,normal,10,4,0
2021-08-06 10:15:00,68,15,26,11,120,high,10,4,0
2021-08-06 10:30:00,74,9,14,6,103,low,10,4,0
2021-08-06 10:45:00,35,6,10,35,86,normal,10,4,0
2021-08-06 11:00:00,62,9,12,32,115,high,11,4,0
2021-08-06 11:15:00,46,10,0,34,90,normal,11,4,0
2021-08-06 11:30:00,63,5,2,31,101,normal,11,4,0
2021-08-06 11:45:00,58,10,2,27,97,normal,11,4,0
2021-08-06 12:00:00,68,0,12,35,115,high,12,4,0
2021-08-06 12:15:00,27,7,0,33,67,normal,12,4,0
2021-08-06 12:30:00,24,4,11,33,72,normal,12,4,0
2021-08-06 12:45:00,70,6,8,35,119,high,12,4,0
2021-08-06 13:00:00,14,19,22,15,70,normal,13,4,0
2021-08-06 13:15:00,72,8,17,28,125,normal,13,4,0
2021-08-06 13:30:00,14,0,26,20,60,normal,13,4,0
2021-08-06 13:45:00,97,4,25,18,144,normal,13,4,0
2021-08-06 14:00:00,23,19,3,19,64,normal,14,4,0
2021-08-06 14:15:00,46,3,32,27,108,normal,14,4,0
2021-08-06 14:30:00,23,17,27,13,80,normal,14,4,0
2021-08-06 14:45:00,48,4,8,17,77,low,14,4,0
2021-08-06 15:00:00,89,13,7,27,136,normal,15,4,0
2021-08-06 15:15:00,48,10,23,26,107,normal,15,4,0
2021-08-06 15:30:00,77,13,19,11,120,normal,15,4,0
2021-08-06 15:45:00,118,8,27,16,169,heavy,15,4,0
2021-08-06 16:00:00,145,19,22,19,205,heavy,16,4,0
2021-08-06 16:15:00,103,23,18,19,163,normal,16,4,0
2021-08-06 16:30:00,126,22,28,16,192,heavy,16,4,0
2021-08-06 16:45:00,120,24,30,10,184,heavy,16,4,0
2021-08-06 17:00:00,128,10,14,18,170,heavy,17,4,0
2021-08-06 17:15:00,142,26,32,10,210,heavy,17,4,0
2021-08-06 17:30:00,121,25,33,13,192,heavy,17,4,0
2021-08-06 17:45:00,144,6,18,12,180,heavy,17,4,0
2021-08-06 18:00:00,116,26,14,18,174,heavy,18,4,0
2021-08-06 18:15:00,138,21,39,17,215,heavy,18,4,0
2021-08-06 18:30:00,103,5,7,13,128,normal,18,4,0
2021-08-06 18:45:00,100,14,10,22,146,normal,18,4,0
2021-08-06 19:00:00,93,11,20,11,135,normal,19,4,0
2021-08-06 19:15:00,97,17,19,33,166,high,19,4,0
2021-08-06 19:30:00,81,9,15,25,130,normal,19,4,0
2021-08-06 19:45:00,101,8,7,10,126,normal,19,4,0
2021-08-06 20:00:00,106,7,7,26,146,normal,20,4,0
2021-08-06 20:15:00,86,8,18,13,125,normal,20,4,0
2021-08-06 20:30:00,74,14,12,20,120,normal,20,4,0
2021-08-06 20:45:00,64,13,13,16,106,low,20,4,0
2021-08-06 21:00:00,60,20,12,32,124,high,21,4,0
2021-08-06 21:15:00,58,15,12,31,116,high,21,4,0
2021-08-06 21:30:00,95,7,18,34,154,high,21,4,0
2021-08-06 21:45:00,5,2,2,29,38,normal,21,4,0
2021-08-06 22:00:00,13,2,0,38,53,normal,22,4,0
2021-08-06 22:15:00,8,1,1,33,43,normal,22,4,0
2021-08-06 22:30:00,5,2,0,31,38,normal,22,4,0
2021-08-06 22:45:00,5,1,1,25,32,normal,22,4,0
2021-08-06 23:00:00,15,2,2,32,51,normal,23,4,0
2021-08-06 23:15:00,13,1,2,38,54,normal,23,4,0
2021-08-06 23:30:00,6,2,1,22,31,normal,23,4,0
2021-08-06 23:45:00,8,1,2,27,38,normal,23,4,0
2021-08-07 00:00:00,9,0,0,39,48,normal,0,5,0
2021-08-07 00:15:00,15,1,1,31,48,normal,0,5,0
2021-08-07 00:30:00,8,0,2,25,35,normal,0,5,0
2021-08-07 00:45:00,15,1,0,29,45,normal,0,5,0
2021-08-07 01:00:00,6,1,1,34,42,normal,1,5,0
2021-08-07 01:15:00,10,2,1,33,46,normal,1,5,0
2021-08-07 01:30:00,9,0,1,23,33,normal,1,5,0
2021-08-07 01:45:00,10,1,0,28,39,normal,1,5,0
2021-08-07 02:00:00,10,2,1,38,51,normal,2,5,0
2021-08-07 02:15:00,9,0,1,38,48,normal,2,5,0
2021-08-07 02:30:00,6,2,2,20,30,normal,2,5,0
2021-08-07 02:45:00,15,0,0,32,47,normal,2,5,0
2021-08-07 03:00:00,9,0,0,22,31,normal,3,5,0
2021-08-07 03:15:00,11,1,0,26,38,normal,3,5,0
2021-08-07 03:30:00,9,0,0,25,34,normal,3,5,0
2021-08-07 03:45:00,14,1,2,20,37,normal,3,5,0
2021-08-07 04:00:00,64,0,2,12,78,low,4,5,0
2021-08-07 04:15:00,60,8,7,11,86,low,4,5,0
2021-08-07 04:30:00,77,5,0,20,102,normal,4,5,0
2021-08-07 04:45:00,59,1,7,11,78,low,4,5,0
2021-08-07 05:00:00,72,2,6,11,91,low,5,5,0
2021-08-07 05:15:00,86,10,2,12,110,low,5,5,0
2021-08-07 05:30:00,79,7,4,10,100,low,5,5,0
2021-08-07 05:45:00,128,29,24,9,190,heavy,5,5,0
2021-08-07 06:00:00,140,15,13,7,175,heavy,6,5,0
2021-08-07 06:15:00,150,28,12,9,199,heavy,6,5,0
2021-08-07 06:30:00,81,19,22,5,127,normal,6,5,0
2021-08-07 06:45:00,88,12,12,6,118,normal,6,5,0
2021-08-07 07:00:00,97,10,16,10,133,normal,7,5,0
2021-08-07 07:15:00,92,11,23,11,137,normal,7,5,0
2021-08-07 07:30:00,109,23,18,13,163,normal,7,5,0
2021-08-07 07:45:00,104,29,21,15,169,heavy,7,5,0
2021-08-07 08:00:00,130,17,17,12,176,heavy,8,5,0
2021-08-07 08:15:00,90,18,25,6,139,normal,8,5,0
2021-08-07 08:30:00,113,12,12,9,146,normal,8,5,0
2021-08-07 08:45:00,98,29,24,5,156,normal,8,5,0
2021-08-07 09:00:00,35,10,11,17,73,low,9,5,0
2021-08-07 09:15:00,31,13,11,7,62,low,9,5,0
2021-08-07 09:30:00,80,9,9,9,107,low,9,5,0
2021-08-07 09:45:00,60,10,8,11,89,low,9,5,0
2021-08-07 10:00:00,67,7,19,12,105,normal,10,5,0
2021-08-07 10:15:00,38,15,9,19,81,normal,10,5,0
2021-08-07 10:30:00,62,11,9,12,94,low,10,5,0
2021-08-07 10:45:00,21,10,0,25,56,normal,10,5,0
2021-08-07 11:00:00,41,0,9,25,75,normal,11,5,0
2021-08-07 11:15:00,57,1,6,29,93,normal,11,5,0
2021-08-07 11:30:00,26,0,11,33,70,normal,11,5,0
2021-08-07 11:45:00,50,9,10,29,98,normal,11,5,0
2021-08-07 12:00:00,56,3,11,28,98,normal,12,5,0
2021-08-07 12:15:00,59,4,8,30,101,normal,12,5,0
2021-08-07 12:30:00,61,9,10,26,106,normal,12,5,0
2021-08-07 12:45:00,56,7,8,31,102,normal,12,5,0
2021-08-07 13:00:00,23,2,5,22,52,normal,13,5,0
2021-08-07 13:15:00,73,8,10,23,114,normal,13,5,0
2021-08-07 13:30:00,98,8,26,18,150,high,13,5,0
2021-08-07 13:45:00,22,6,23,10,61,normal,13,5,0
2021-08-07 14:00:00,38,7,27,22,94,normal,14,5,0
2021-08-07 14:15:00,76,12,8,15,111,low,14,5,0
2021-08-07 14:30:00,79,15,26,30,150,high,14,5,0
2021-08-07 14:45:00,76,6,6,29,117,normal,14,5,0
2021-08-07 15:00:00,62,6,29,23,120,high,15,5,0
2021-08-07 15:15:00,19,2,23,25,69,normal,15,5,0
2021-08-07 15:30:00,13,10,35,19,77,normal,15,5,0
2021-08-07 15:45:00,105,6,16,18,145,normal,15,5,0
2021-08-07 16:00:00,144,14,12,16,186,heavy,16,5,0
2021-08-07 16:15:00,121,17,35,14,187,heavy,16,5,0
2021-08-07 16:30:00,145,5,20,12,182,heavy,16,5,0
2021-08-07 16:45:00,127,11,24,16,178,heavy,16,5,0
2021-08-07 17:00:00,116,11,11,16,154,normal,17,5,0
2021-08-07 17:15:00,128,9,29,20,186,heavy,17,5,0
2021-08-07 17:30:00,116,18,32,18,184,heavy,17,5,0
2021-08-07 17:45:00,149,20,17,13,199,heavy,17,5,0
2021-08-07 18:00:00,144,27,22,16,209,heavy,18,5,0
2021-08-07 18:15:00,145,6,40,13,204,heavy,18,5,0
2021-08-07 18:30:00,63,2,11,32,108,normal,18,5,0
2021-08-07 18:45:00,110,16,18,34,178,heavy,18,5,0
2021-08-07 19:00:00,63,11,10,23,107,normal,19,5,0
2021-08-07 19:15:00,106,8,10,31,155,high,19,5,0
2021-08-07 19:30:00,50,9,11,22,92,normal,19,5,0
2021-08-07 19:45:00,53,13,12,15,93,low,19,5,0
2021-08-07 20:00:00,81,0,18,12,111,normal,20,5,0
2021-08-07 20:15:00,90,20,20,10,140,normal,20,5,0
2021-08-07 20:30:00,56,12,9,22,99,normal,20,5,0
2021-08-07 20:45:00,90,0,11,32,133,high,20,5,0
2021-08-07 21:00:00,102,4,8,28,142,normal,21,5,0
2021-08-07 21:15:00,99,0,11,21,131,normal,21,5,0
2021-08-07 21:30:00,85,2,16,25,128,normal,21,5,0
2021-08-07 21:45:00,13,2,2,26,43,normal,21,5,0
2021-08-07 22:00:00,12,1,1,20,34,normal,22,5,0
2021-08-07 22:15:00,7,0,1,35,43,normal,22,5,0
2021-08-07 22:30:00,9,0,2,38,49,normal,22,5,0
2021-08-07 22:45:00,8,1,0,26,35,normal,22,5,0
2021-08-07 23:00:00,5,0,0,35,40,normal,23,5,0
2021-08-07 23:15:00,13,1,2,30,46,normal,23,5,0
2021-08-07 23:30:00,7,2,2,37,48,normal,23,5,0
2021-08-07 23:45:00,9,2,2,28,41,normal,23,5,0
2021-08-08 00:00:00,6,1,1,35,43,normal,0,6,1
2021-08-08 00:15:00,14,0,1,20,35,normal,0,6,1
2021-08-08 00:30:00,11,0,2,39,52,normal,0,6,1
2021-08-08 00:45:00,9,2,0,28,39,normal,0,6,1
2021-08-08 01:00:00,5,0,0,22,27,normal,1,6,1
2021-08-08 01:15:00,9,0,0,24,33,normal,1,6,1
2021-08-08 01:30:00,5,2,2,30,39,normal,1,6,1
2021-08-08 01:45:00,9,0,1,27,37,normal,1,6,1
2021-08-08 02:00:00,9,1,0,39,49,normal,2,6,1
2021-08-08 02:15:00,6,0,0,33,39,normal,2,6,1
2021-08-08 02:30:00,13,2,1,30,46,normal,2,6,1
2021-08-08 02:45:00,5,0,1,34,40,normal,2,6,1
2021-08-08 03:00:00,5,0,0,34,39,normal,3,6,1
2021-08-08 03:15:00,9,2,2,29,42,normal,3,6,1
2021-08-08 03:30:00,9,1,0,34,44,normal,3,6,1
2021-08-08 03:45:00,8,0,0,40,48,normal,3,6,1
2021-08-08 04:00:00,64,10,7,15,96,low,4,6,1
2021-08-08 04:15:00,66,3,1,26,96,normal,4,6,1
2021-08-08 04:30:00,57,10,2,18,87,low,4,6,1
2021-08-08 04:45:00,76,7,4,15,102,low,4,6,1
2021-08-08 05:00:00,71,8,5,21,105,normal,5,6,1
2021-08-08 05:15:00,65,0,6,30,101,normal,5,6,1
2021-08-08 05:30:00,54,2,3,13,72,low,5,6,1
2021-08-08 05:45:00,107,10,23,5,145,normal,5,6,1
2021-08-08 06:00:00,102,28,22,11,163,normal,6,6,1
2021-08-08 06:15:00,118,16,19,8,161,normal,6,6,1
2021-08-08 06:30:00,144,13,10,5,172,heavy,6,6,1
2021-08-08 06:45:00,147,21,12,11,191,heavy,6,6,1
2021-08-08 07:00:00,116,10,11,13,150,normal,7,6,1
2021-08-08 07:15:00,142,11,25,5,183,heavy,7,6,1
2021-08-08 07:30:00,105,25,13,9,152,normal,7,6,1
2021-08-08 07:45:00,138,23,17,12,190,heavy,7,6,1
2021-08-08 08:00:00,144,15,15,14,188,heavy,8,6,1
2021-08-08 08:15:00,122,24,17,9,172,heavy,8,6,1
2021-08-08 08:30:00,137,28,17,14,196,heavy,8,6,1
2021-08-08 08:45:00,113,16,12,12,153,normal,8,6,1
2021-08-08 09:00:00,78,8,11,9,106,low,9,6,1
2021-08-08 09:15:00,44,12,27,13,96,normal,9,6,1
2021-08-08 09:30:00,57,13,11,14,95,low,9,6,1
2021-08-08 09:45:00,72,9,27,12,120,high,9,6,1
2021-08-08 10:00:00,58,14,7,16,95,low,10,6,1
2021-08-08 10:15:00,80,9,26,10,125,high,10,6,1
2021-08-08 10:30:00,68,12,10,18,108,low,10,6,1
2021-08-08 10:45:00,57,8,13,32,110,normal,10,6,1
2021-08-08 11:00:00,37,10,5,33,85,normal,11,6,1
2021-08-08 11:15:00,59,0,1,26,86,normal,11,6,1
2021-08-08 11:30:00,31,9,13,33,86,normal,11,6,1
2021-08-08 11:45:00,54,8,9,30,101,normal,11,6,1
2021-08-08 12:00:00,33,6,0,29,68,normal,12,6,1
2021-08-08 12:15:00,65,0,13,28,106,normal,12,6,1
2021-08-08 12:30:00,24,4,6,29,63,normal,12,6,1
2021-08-08 12:45:00,46,10,12,29,97,normal,12,6,1
2021-08-08 13:00:00,37,16,3,23,79,normal,13,6,1
2021-08-08 13:15:00,42,16,26,17,101,normal,13,6,1
2021-08-08 13:30:00,74,8,7,29,118,normal,13,6,1
2021-08-08 13:45:00,43,12,21,11,87,normal,13,6,1
2021-08-08 14:00:00,72,5,11,29,117,normal,14,6,1
2021-08-08 14:15:00,62,14,22,19,117,normal,14,6,1
2021-08-08 14:30:00,55,13,16,10,94,normal,14,6,1
2021-08-08 14:45:00,97,9,15,26,147,normal,14,6,1
2021-08-08 15:00:00,42,17,2,11,72,low,15,6,1
2021-08-08 15:15:00,16,14,14,18,62,low,15,6,1
2021-08-08 15:30:00,73,0,33,30,136,high,15,6,1
2021-08-08 15:45:00,106,5,29,14,154,high,15,6,1
2021-08-08 16:00:00,142,16,18,10,186,heavy,16,6,1
2021-08-08 16:15:00,112,8,21,17,158,normal,16,6,1
2021-08-08 16:30:00,129,7,26,15,177,heavy,16,6,1
2021-08-08 16:45:00,131,11,10,18,170,heavy,16,6,1
2021-08-08 17:00:00,104,17,12,16,149,normal,17,6,1
2021-08-08 17:15:00,128,19,32,20,199,heavy,17,6,1
2021-08-08 17:30:00,144,16,14,11,185,heavy,17,6,1
2021-08-08 17:45:00,150,5,11,18,184,heavy,17,6,1
2021-08-08 18:00:00,128,20,16,16,180,heavy,18,6,1
2021-08-08 18:15:00,104,28,12,11,155,normal,18,6,1
2021-08-08 18:30:00,62,13,6,15,96,low,18,6,1
2021-08-08 18:45:00,66,16,17,35,134,high,18,6,1
2021-08-08 19:00:00,103,10,8,27,148,normal,19,6,1
2021-08-08 19:15:00,63,0,10,18,91,low,19,6,1
2021-08-08 19:30:00,100,11,10,35,156,high,19,6,1
2021-08-08 19:45:00,70,1,7,20,98,normal,19,6,1
2021-08-08 20:00:00,82,13,6,18,119,normal,20,6,1
2021-08-08 20:15:00,98,16,17,33,164,high,20,6,1
2021-08-08 20:30:00,60,4,20,31,115,high,20,6,1
2021-08-08 20:45:00,90,18,15,23,146,normal,20,6,1
2021-08-08 21:00:00,64,9,8,25,106,normal,21,6,1
2021-08-08 21:15:00,82,14,11,18,125,normal,21,6,1
2021-08-08 21:30:00,55,9,15,17,96,low,21,6,1
2021-08-08 21:45:00,7,1,2,24,34,normal,21,6,1
2021-08-08 22:00:00,11,0,1,28,40,normal,22,6,1
2021-08-08 22:15:00,9,1,1,20,31,normal,22,6,1
2021-08-08 22:30:00,15,0,2,40,57,normal,22,6,1
2021-08-08 22:45:00,12,1,1,24,38,normal,22,6,1
2021-08-08 23:00:00,8,0,1,32,41,normal,23,6,1
2021-08-08 23:15:00,7,2,0,36,45,normal,23,6,1
2021-08-08 23:30:00,8,1,2,36,47,normal,23,6,1
2021-08-08 23:45:00,6,2,0,23,31,normal,23,6,1
2021-08-09 00:00:00,12,1,2,33,48,normal,0,0,0
2021-08-09 00:15:00,9,0,1,25,35,normal,0,0,0
2021-08-09 00:30:00,13,0,2,23,38,normal,0,0,0
2021-08-09 00:45:00,15,2,0,28,45,normal,0,0,0
2021-08-09 01:00:00,9,1,1,31,42,normal,1,0,0
2021-08-09 01:15:00,10,1,1,32,44,normal,1,0,0
2021-08-09 01:30:00,10,0,0,33,43,normal,1,0,0
2021-08-09 01:45:00,12,1,0,35,48,normal,1,0,0
2021-08-09 02:00:00,15,0,2,27,44,normal,2,0,0
2021-08-09 02:15:00,13,1,2,34,50,normal,2,0,0
2021-08-09 02:30:00,12,0,1,35,48,normal,2,0,0
2021-08-09 02:45:00,13,2,0,28,43,normal,2,0,0
2021-08-09 03:00:00,6,1,1,21,29,normal,3,0,0
2021-08-09 03:15:00,12,1,0,27,40,normal,3,0,0
2021-08-09 03:30:00,8,0,0,20,28,normal,3,0,0
2021-08-09 03:45:00,8,2,2,35,47,normal,3,0,0
2021-08-09 04:00:00,65,1,6,18,90,low,4,0,0
2021-08-09 04:15:00,60,8,6,10,84,low,4,0,0
2021-08-09 04:30:00,56,10,4,11,81,low,4,0,0
2021-08-09 04:45:00,57,0,3,21,81,normal,4,0,0
2021-08-09 05:00:00,78,5,6,12,101,low,5,0,0
2021-08-09 05:15:00,67,10,1,25,103,normal,5,0,0
2021-08-09 05:30:00,83,3,7,20,113,normal,5,0,0
2021-08-09 05:45:00,102,25,15,8,150,normal,5,0,0
2021-08-09 06:00:00,96,22,10,8,136,normal,6,0,0
2021-08-09 06:15:00,101,21,19,15,156,normal,6,0,0
2021-08-09 06:30:00,88,21,24,13,146,normal,6,0,0
2021-08-09 06:45:00,118,11,16,5,150,normal,6,0,0
2021-08-09 07:00:00,106,14,15,11,146,normal,7,0,0
2021-08-09 07:15:00,150,30,14,15,209,heavy,7,0,0
2021-08-09 07:30:00,80,18,23,7,128,normal,7,0,0
2021-08-09 07:45:00,142,29,15,5,191,heavy,7,0,0
2021-08-09 08:00:00,81,30,22,6,139,normal,8,0,0
2021-08-09 08:15:00,109,18,14,8,149,normal,8,0,0
2021-08-09 08:30:00,130,14,13,6,163,normal,8,0,0
2021-08-09 08:45:00,150,19,23,12,204,heavy,8,0,0
2021-08-09 09:00:00,63,5,14,10,92,low,9,0,0
2021-08-09 09:15:00,36,6,15,6,63,low,9,0,0
2021-08-09 09:30:00,60,6,6,11,83,low,9,0,0
2021-08-09 09:45:00,46,11,9,17,83,low,9,0,0
2021-08-09 10:00:00,78,15,26,15,134,high,10,0,0
2021-08-09 10:15:00,54,5,11,7,77,low,10,0,0
2021-08-09 10:30:00,39,10,28,11,88,normal,10,0,0
2021-08-09 10:45:00,62,1,11,34,108,normal,10,0,0
2021-08-09 11:00:00,59,2,11,33,105,normal,11,0,0
2021-08-09 11:15:00,61,4,8,34,107,normal,11,0,0
2021-08-09 11:30:00,62,10,12,35,119,high,11,0,0
2021-08-09 11:45:00,42,8,6,35,91,normal,11,0,0
2021-08-09 12:00:00,64,5,1,34,104,normal,12,0,0
2021-08-09 12:15:00,57,5,2,29,93,normal,12,0,0
2021-08-09 12:30:00,68,4,9,26,107,normal,12,0,0
2021-08-09 12:45:00,24,7,2,29,62,normal,12,0,0
2021-08-09 13:00:00,12,1,33,24,70,normal,13,0,0
2021-08-09 13:15:00,85,2,30,16,133,high,13,0,0
2021-08-09 13:30:00,41,18,30,14,103,normal,13,0,0
2021-08-09 13:45:00,6,16,26,18,66,normal,13,0,0
2021-08-09 14:00:00,75,1,18,20,114,normal,14,0,0
2021-08-09 14:15:00,92,15,17,15,139,normal,14,0,0
2021-08-09 14:30:00,71,2,5,20,98,normal,14,0,0
2021-08-09 14:45:00,98,20,21,14,153,normal,14,0,0
2021-08-09 15:00:00,77,6,16,28,127,normal,15,0,0
2021-08-09 15:15:00,61,0,24,19,104,normal,15,0,0
2021-08-09 15:30:00,90,5,13,16,124,normal,15,0,0
2021-08-09 15:45:00,119,8,34,12,173,heavy,15,0,0
2021-08-09 16:00:00,120,17,37,14,188,heavy,16,0,0
2021-08-09 16:15:00,141,23,24,15,203,heavy,16,0,0
2021-08-09 16:30:00,118,30,28,11,187,heavy,16,0,0
2021-08-09 16:45:00,139,30,33,16,218,heavy,16,0,0
2021-08-09 17:00:00,132,16,13,11,172,heavy,17,0,0
2021-08-09 17:15:00,115,26,34,20,195,heavy,17,0,0
2021-08-09 17:30:00,105,16,32,17,170,heavy,17,0,0
2021-08-09 17:45:00,116,10,27,11,164,high,17,0,0
2021-08-09 18:00:00,147,22,17,20,206,heavy,18,0,0
2021-08-09 18:15:00,138,13,15,13,179,heavy,18,0,0
2021-08-09 18:30:00,84,4,14,33,135,high,18,0,0
2021-08-09 18:45:00,86,11,12,14,123,normal,18,0,0
2021-08-09 19:00:00,75,2,17,31,125,high,19,0,0
2021-08-09 19:15:00,51,5,5,17,78,low,19,0,0
2021-08-09 19:30:00,76,18,5,21,120,normal,19,0,0
2021-08-09 19:45:00,67,12,10,16,105,low,19,0,0
2021-08-09 20:00:00,99,4,9,19,131,normal,20,0,0
2021-08-09 20:15:00,66,19,16,30,131,normal,20,0,0
2021-08-09 20:30:00,69,0,8,13,90,low,20,0,0
2021-08-09 20:45:00,50,18,5,34,107,normal,20,0,0
2021-08-09 21:00:00,56,19,11,24,110,normal,21,0,0
2021-08-09 21:15:00,107,17,11,28,163,normal,21,0,0
2021-08-09 21:30:00,110,16,7,34,167,normal,21,0,0
2021-08-09 21:45:00,5,0,1,24,30,normal,21,0,0
2021-08-09 22:00:00,6,0,1,36,43,normal,22,0,0
2021-08-09 22:15:00,5,1,2,20,28,normal,22,0,0
2021-08-09 22:30:00,6,2,1,28,37,normal,22,0,0
2021-08-09 22:45:00,6,0,2,34,42,normal,22,0,0
2021-08-09 23:00:00,5,0,2,24,31,normal,23,0,0
2021-08-09 23:15:00,11,2,2,32,47,normal,23,0,0
2021-08-09 23:30:00,5,2,2,37,46,normal,23,0,0
2021-08-09 23:45:00,10,1,0,25,36,normal,23,0,0
2021-08-10 00:00:00,31,0,4,4,39,low,0,1,0
2021-08-10 00:15:00,49,0,3,3,55,low,0,1,0
2021-08-10 00:30:00,46,0,3,6,55,low,0,1,0
2021-08-10 00:45:00,51,0,2,5,58,low,0,1,0
2021-08-10 01:00:00,57,6,15,16,94,low,1,1,0
2021-08-10 01:15:00,44,0,5,4,53,low,1,1,0
2021-08-10 01:30:00,37,0,1,4,42,low,1,1,0
2021-08-10 01:45:00,42,4,4,5,55,low,1,1,0
2021-08-10 02:00:00,51,0,9,7,67,low,2,1,0
2021-08-10 02:15:00,34,0,4,7,45,low,2,1,0
2021-08-10 02:30:00,45,0,1,1,47,low,2,1,0
2021-08-10 02:45:00,45,0,1,3,49,low,2,1,0
2021-08-10 03:00:00,50,0,3,0,53,low,3,1,0
2021-08-10 03:15:00,34,0,4,4,42,low,3,1,0
2021-08-10 03:30:00,129,22,42,1,194,heavy,3,1,0
2021-08-10 03:45:00,144,16,49,0,209,heavy,3,1,0
2021-08-10 04:00:00,111,28,20,3,162,normal,4,1,0
2021-08-10 04:15:00,67,11,10,16,104,low,4,1,0
2021-08-10 04:30:00,65,24,7,16,112,normal,4,1,0
2021-08-10 04:45:00,94,27,7,16,144,normal,4,1,0
2021-08-10 05:00:00,94,20,8,7,129,normal,5,1,0
2021-08-10 05:15:00,67,29,5,10,111,low,5,1,0
2021-08-10 05:30:00,56,12,2,14,84,low,5,1,0
2021-08-10 05:45:00,57,13,3,11,84,low,5,1,0
2021-08-10 06:00:00,129,22,42,1,194,heavy,6,1,0
2021-08-10 06:15:00,144,16,49,0,209,heavy,6,1,0
2021-08-10 06:30:00,111,28,20,3,162,normal,6,1,0
2021-08-10 06:45:00,120,27,46,3,196,heavy,6,1,0
2021-08-10 07:00:00,102,39,47,1,189,heavy,7,1,0
2021-08-10 07:15:00,145,23,27,0,195,heavy,7,1,0
2021-08-10 07:30:00,114,37,21,5,177,heavy,7,1,0
2021-08-10 07:45:00,108,18,22,1,149,normal,7,1,0
2021-08-10 08:00:00,122,28,33,1,184,heavy,8,1,0
2021-08-10 08:15:00,114,39,30,3,186,heavy,8,1,0
2021-08-10 08:30:00,150,36,25,1,212,heavy,8,1,0
2021-08-10 08:45:00,107,10,49,2,168,heavy,8,1,0
2021-08-10 09:00:00,124,24,22,0,170,heavy,9,1,0
2021-08-10 09:15:00,77,16,39,29,161,high,9,1,0
2021-08-10 09:30:00,15,23,30,21,89,normal,9,1,0
2021-08-10 09:45:00,32,22,38,21,113,high,9,1,0
2021-08-10 10:00:00,68,13,29,24,134,high,10,1,0
2021-08-10 10:15:00,27,16,36,30,109,normal,10,1,0
2021-08-10 10:30:00,76,7,11,15,109,low,10,1,0
2021-08-10 10:45:00,41,23,20,17,101,normal,10,1,0
2021-08-10 11:00:00,33,10,3,29,75,normal,11,1,0
2021-08-10 11:15:00,58,8,14,29,109,normal,11,1,0
2021-08-10 11:30:00,65,7,11,26,109,normal,11,1,0
2021-08-10 11:45:00,47,9,6,29,91,normal,11,1,0
2021-08-10 12:00:00,38,10,5,25,78,normal,12,1,0
2021-08-10 12:15:00,57,8,12,29,106,normal,12,1,0
2021-08-10 12:30:00,20,6,4,20,50,normal,12,1,0
2021-08-10 12:45:00,24,9,14,23,70,normal,12,1,0
2021-08-10 13:00:00,52,10,13,21,96,normal,13,1,0
2021-08-10 13:15:00,79,15,36,18,148,high,13,1,0
2021-08-10 13:30:00,84,24,22,18,148,normal,13,1,0
2021-08-10 13:45:00,59,19,35,16,129,high,13,1,0
2021-08-10 14:00:00,88,26,31,19,164,high,14,1,0
2021-08-10 14:15:00,24,11,32,13,80,normal,14,1,0
2021-08-10 14:30:00,110,17,23,20,170,heavy,14,1,0
2021-08-10 14:45:00,29,26,5,6,66,low,14,1,0
2021-08-10 15:00:00,43,26,11,20,100,normal,15,1,0
2021-08-10 15:15:00,68,28,9,15,120,normal,15,1,0
2021-08-10 15:30:00,108,16,8,18,150,normal,15,1,0
2021-08-10 15:45:00,101,26,8,14,149,normal,15,1,0
2021-08-10 16:00:00,141,31,36,6,214,heavy,16,1,0
2021-08-10 16:15:00,120,25,28,5,178,heavy,16,1,0
2021-08-10 16:30:00,137,23,44,5,209,heavy,16,1,0
2021-08-10 16:45:00,124,11,30,7,172,heavy,16,1,0
2021-08-10 17:00:00,145,25,49,7,226,heavy,17,1,0
2021-08-10 17:15:00,122,37,23,8,190,heavy,17,1,0
2021-08-10 17:30:00,136,30,20,9,195,heavy,17,1,0
2021-08-10 17:45:00,145,18,40,9,212,heavy,17,1,0
2021-08-10 18:00:00,138,34,28,5,205,heavy,18,1,0
2021-08-10 18:15:00,123,10,29,8,170,heavy,18,1,0
2021-08-10 18:30:00,105,15,21,9,150,normal,18,1,0
2021-08-10 18:45:00,75,22,20,11,128,normal,18,1,0
2021-08-10 19:00:00,90,12,10,13,125,normal,19,1,0
2021-08-10 19:15:00,102,22,20,16,160,normal,19,1,0
2021-08-10 19:30:00,61,18,15,27,121,normal,19,1,0
2021-08-10 19:45:00,70,8,14,6,98,low,19,1,0
2021-08-10 20:00:00,80,17,12,34,143,high,20,1,0
2021-08-10 20:15:00,62,12,14,19,107,normal,20,1,0
2021-08-10 20:30:00,96,5,11,13,125,normal,20,1,0
2021-08-10 20:45:00,102,6,12,13,133,normal,20,1,0
2021-08-10 21:00:00,91,14,15,6,126,normal,21,1,0
2021-08-10 21:15:00,95,8,17,13,133,normal,21,1,0
2021-08-10 21:30:00,75,15,12,21,123,normal,21,1,0
2021-08-10 21:45:00,53,21,20,10,104,normal,21,1,0
2021-08-10 22:00:00,13,1,0,19,33,normal,22,1,0
2021-08-10 22:15:00,10,0,1,24,35,normal,22,1,0
2021-08-10 22:30:00,16,2,0,33,51,normal,22,1,0
2021-08-10 22:45:00,11,1,0,29,41,normal,22,1,0
2021-08-10 23:00:00,18,2,1,13,34,low,23,1,0
2021-08-10 23:15:00,15,0,1,11,27,low,23,1,0
2021-08-10 23:30:00,14,1,0,33,48,normal,23,1,0
2021-08-10 23:45:00,17,2,0,22,41,normal,23,1,0
2021-08-11 00:00:00,12,2,1,17,32,low,0,2,0
2021-08-11 00:15:00,18,0,0,29,47,normal,0,2,0
2021-08-11 00:30:00,16,1,0,14,31,low,0,2,0
2021-08-11 00:45:00,20,0,0,14,34,low,0,2,0
2021-08-11 01:00:00,20,1,1,30,52,normal,1,2,0
2021-08-11 01:15:00,15,0,1,23,39,normal,1,2,0
2021-08-11 01:30:00,16,0,1,26,43,normal,1,2,0
2021-08-11 01:45:00,18,4,0,11,33,low,1,2,0
2021-08-11 02:00:00,17,3,1,36,57,normal,2,2,0
2021-08-11 02:15:00,14,4,1,10,29,low,2,2,0
2021-08-11 02:30:00,18,2,1,25,46,normal,2,2,0
2021-08-11 02:45:00,12,2,0,19,33,normal,2,2,0
2021-08-11 03:00:00,11,4,0,30,45,normal,3,2,0
2021-08-11 03:15:00,19,1,1,36,57,normal,3,2,0
2021-08-11 03:30:00,10,4,0,36,50,normal,3,2,0
2021-08-11 03:45:00,20,1,1,32,54,normal,3,2,0
2021-08-11 04:00:00,15,5,1,40,61,normal,4,2,0
2021-08-11 04:15:00,104,6,5,1,116,normal,4,2,0
2021-08-11 04:30:00,109,25,3,8,145,normal,4,2,0
2021-08-11 04:45:00,82,23,8,20,133,normal,4,2,0
2021-08-11 05:00:00,81,25,1,18,125,normal,5,2,0
2021-08-11 05:15:00,95,16,10,1,122,normal,5,2,0
2021-08-11 05:30:00,91,24,7,6,128,normal,5,2,0
2021-08-11 05:45:00,81,30,10,0,121,normal,5,2,0
2021-08-11 06:00:00,125,13,26,2,166,high,6,2,0
2021-08-11 06:15:00,125,39,49,3,216,heavy,6,2,0
2021-08-11 06:30:00,125,34,37,1,197,heavy,6,2,0
2021-08-11 06:45:00,125,19,25,4,173,heavy,6,2,0
2021-08-11 07:00:00,125,15,49,0,189,heavy,7,2,0
2021-08-11 07:15:00,125,32,50,5,212,heavy,7,2,0
2021-08-11 07:30:00,125,38,50,1,214,heavy,7,2,0
2021-08-11 07:45:00,125,29,29,3,186,heavy,7,2,0
2021-08-11 08:00:00,125,31,48,4,208,heavy,8,2,0
2021-08-11 08:15:00,125,32,50,0,207,heavy,8,2,0
2021-08-11 08:30:00,125,31,45,0,201,heavy,8,2,0
2021-08-11 08:45:00,125,21,20,1,167,normal,8,2,0
2021-08-11 09:00:00,125,28,36,0,189,heavy,9,2,0
2021-08-11 09:15:00,39,10,37,16,102,normal,9,2,0
2021-08-11 09:30:00,89,8,12,13,122,normal,9,2,0
2021-08-11 09:45:00,51,16,16,13,96,normal,9,2,0
2021-08-11 10:00:00,17,9,18,28,72,normal,10,2,0
2021-08-11 10:15:00,48,25,36,21,130,high,10,2,0
2021-08-11 10:30:00,93,7,30,16,146,high,10,2,0
2021-08-11 10:45:00,55,15,36,15,121,high,10,2,0
2021-08-11 11:00:00,51,10,8,22,91,normal,11,2,0
2021-08-11 11:15:00,51,7,3,24,85,normal,11,2,0
2021-08-11 11:30:00,51,9,7,30,97,normal,11,2,0
2021-08-11 11:45:00,51,7,14,20,92,normal,11,2,0
2021-08-11 12:00:00,51,10,14,20,95,normal,12,2,0
2021-08-11 12:15:00,51,10,6,22,89,normal,12,2,0
2021-08-11 12:30:00,51,8,11,22,92,normal,12,2,0
2021-08-11 12:45:00,51,6,10,26,93,normal,12,2,0
2021-08-11 13:00:00,51,7,7,27,92,normal,13,2,0
2021-08-11 13:15:00,104,17,25,20,166,normal,13,2,0
2021-08-11 13:30:00,6,28,27,14,75,normal,13,2,0
2021-08-11 13:45:00,54,29,37,9,129,high,13,2,0
2021-08-11 14:00:00,43,13,30,20,106,normal,14,2,0
2021-08-11 14:15:00,60,21,26,11,118,high,14,2,0
2021-08-11 14:30:00,101,23,8,20,152,normal,14,2,0
2021-08-11 14:45:00,62,26,19,11,118,normal,14,2,0
2021-08-11 15:00:00,39,24,13,11,87,low,15,2,0
2021-08-11 15:15:00,90,20,35,7,152,high,15,2,0
2021-08-11 15:30:00,109,30,22,20,181,heavy,15,2,0
2021-08-11 15:45:00,68,26,25,20,139,normal,15,2,0
2021-08-11 16:00:00,142,22,37,6,207,heavy,16,2,0
2021-08-11 16:15:00,113,14,20,5,152,normal,16,2,0
2021-08-11 16:30:00,142,13,37,8,200,heavy,16,2,0
2021-08-11 16:45:00,108,23,26,9,166,high,16,2,0
2021-08-11 17:00:00,122,29,30,7,188,heavy,17,2,0
2021-08-11 17:15:00,133,12,30,7,182,heavy,17,2,0
2021-08-11 17:30:00,118,23,38,10,189,heavy,17,2,0
2021-08-11 17:45:00,121,35,26,8,190,heavy,17,2,0
2021-08-11 18:00:00,116,23,20,8,167,normal,18,2,0
2021-08-11 18:15:00,132,12,27,8,179,heavy,18,2,0
2021-08-11 18:30:00,144,17,33,7,201,heavy,18,2,0
2021-08-11 18:45:00,103,21,11,11,146,normal,18,2,0
2021-08-11 19:00:00,107,15,10,15,147,normal,19,2,0
2021-08-11 19:15:00,50,10,10,17,87,low,19,2,0
2021-08-11 19:30:00,108,15,10,6,139,normal,19,2,0
2021-08-11 19:45:00,108,24,15,29,176,heavy,19,2,0
2021-08-11 20:00:00,101,6,15,13,135,normal,20,2,0
2021-08-11 20:15:00,55,17,12,19,103,normal,20,2,0
2021-08-11 20:30:00,77,7,20,16,120,normal,20,2,0
2021-08-11 20:45:00,91,12,19,8,130,normal,20,2,0
2021-08-11 21:00:00,95,25,17,29,166,normal,21,2,0
2021-08-11 21:15:00,78,17,17,27,139,normal,21,2,0
2021-08-11 21:30:00,98,16,16,21,151,normal,21,2,0
2021-08-11 21:45:00,86,13,11,35,145,high,21,2,0
2021-08-11 22:00:00,18,4,0,16,38,low,22,2,0
2021-08-11 22:15:00,18,5,0,12,35,low,22,2,0
2021-08-11 22:30:00,18,2,1,25,46,normal,22,2,0
2021-08-11 22:45:00,18,1,0,17,36,low,22,2,0
2021-08-11 23:00:00,18,5,0,21,44,normal,23,2,0
2021-08-11 23:15:00,18,0,1,12,31,low,23,2,0
2021-08-11 23:30:00,18,3,1,28,50,normal,23,2,0
2021-08-11 23:45:00,18,4,1,40,63,normal,23,2,0
2021-08-12 00:00:00,18,1,1,39,59,normal,0,3,0
2021-08-12 00:15:00,18,4,0,30,52,normal,0,3,0
2021-08-12 00:30:00,18,5,1,13,37,low,0,3,0
2021-08-12 00:45:00,18,2,0,37,57,normal,0,3,0
2021-08-12 01:00:00,18,0,0,13,31,low,1,3,0
2021-08-12 01:15:00,18,5,0,11,34,low,1,3,0
2021-08-12 01:30:00,18,5,1,12,36,low,1,3,0
2021-08-12 01:45:00,18,1,1,16,36,low,1,3,0
2021-08-12 02:00:00,18,1,1,34,54,normal,2,3,0
2021-08-12 02:15:00,18,1,0,24,43,normal,2,3,0
2021-08-12 02:30:00,18,0,0,23,41,normal,2,3,0
2021-08-12 02:45:00,18,0,0,27,45,normal,2,3,0
2021-08-12 03:00:00,18,5,0,28,51,normal,3,3,0
2021-08-12 03:15:00,18,1,0,14,33,low,3,3,0
2021-08-12 03:30:00,18,5,0,25,48,normal,3,3,0
2021-08-12 03:45:00,18,4,1,30,53,normal,3,3,0
2021-08-12 04:00:00,18,5,1,30,54,normal,4,3,0
2021-08-12 04:15:00,62,24,7,2,95,low,4,3,0
2021-08-12 04:30:00,51,23,6,1,81,low,4,3,0
2021-08-12 04:45:00,114,23,10,19,166,normal,4,3,0
2021-08-12 05:00:00,85,22,9,9,125,normal,5,3,0
2021-08-12 05:15:00,102,24,4,20,150,normal,5,3,0
2021-08-12 05:30:00,101,18,3,17,139,normal,5,3,0
2021-08-12 05:45:00,116,19,0,17,152,normal,5,3,0
2021-08-12 06:00:00,117,38,50,5,210,heavy,6,3,0
2021-08-12 06:15:00,114,32,34,2,182,heavy,6,3,0
2021-08-12 06:30:00,120,17,23,1,161,normal,6,3,0
2021-08-12 06:45:00,145,20,25,2,192,heavy,6,3,0
2021-08-12 07:00:00,125,30,48,1,204,heavy,7,3,0
2021-08-12 07:15:00,103,27,45,1,176,heavy,7,3,0
2021-08-12 07:30:00,114,20,43,1,178,heavy,7,3,0
2021-08-12 07:45:00,145,10,44,1,200,heavy,7,3,0
2021-08-12 08:00:00,147,31,20,4,202,heavy,8,3,0
2021-08-12 08:15:00,104,24,40,0,168,heavy,8,3,0
2021-08-12 08:30:00,124,11,22,0,157,normal,8,3,0
2021-08-12 08:45:00,101,37,31,4,173,heavy,8,3,0
2021-08-12 09:00:00,144,30,37,1,212,heavy,9,3,0
2021-08-12 09:15:00,24,18,37,18,97,normal,9,3,0
2021-08-12 09:30:00,24,8,17,25,74,normal,9,3,0
2021-08-12 09:45:00,16,22,12,20,70,normal,9,3,0
2021-08-12 10:00:00,26,2,39,26,93,normal,10,3,0
2021-08-12 10:15:00,90,7,18,15,130,normal,10,3,0
2021-08-12 10:30:00,59,6,11,11,87,low,10,3,0
2021-08-12 10:45:00,28,7,22,18,75,normal,10,3,0
2021-08-12 11:00:00,60,5,14,21,100,normal,11,3,0
2021-08-12 11:15:00,69,9,8,23,109,normal,11,3,0
2021-08-12 11:30:00,59,9,12,26,106,normal,11,3,0
2021-08-12 11:45:00,24,10,5,21,60,normal,11,3,0
2021-08-12 12:00:00,41,7,7,21,76,normal,12,3,0
2021-08-12 12:15:00,48,10,9,29,96,normal,12,3,0
2021-08-12 12:30:00,59,10,14,23,106,normal,12,3,0
2021-08-12 12:45:00,67,7,12,28,114,normal,12,3,0
2021-08-12 13:00:00,52,9,8,20,89,normal,13,3,0
2021-08-12 13:15:00,45,26,29,10,110,normal,13,3,0
2021-08-12 13:30:00,14,21,7,18,60,low,13,3,0
2021-08-12 13:45:00,55,22,24,10,111,normal,13,3,0
2021-08-12 14:00:00,45,14,39,5,103,normal,14,3,0
2021-08-12 14:15:00,90,17,16,11,134,normal,14,3,0
2021-08-12 14:30:00,33,21,25,5,84,normal,14,3,0
2021-08-12 14:45:00,118,25,31,13,187,heavy,14,3,0
2021-08-12 15:00:00,86,28,13,5,132,normal,15,3,0
2021-08-12 15:15:00,105,29,22,12,168,heavy,15,3,0
2021-08-12 15:30:00,10,19,26,8,63,normal,15,3,0
2021-08-12 15:45:00,46,22,18,9,95,normal,15,3,0
2021-08-12 16:00:00,105,35,48,6,194,heavy,16,3,0
2021-08-12 16:15:00,135,37,34,5,211,heavy,16,3,0
2021-08-12 16:30:00,103,29,44,6,182,heavy,16,3,0
2021-08-12 16:45:00,113,13,42,10,178,heavy,16,3,0
2021-08-12 17:00:00,103,20,27,9,159,high,17,3,0
2021-08-12 17:15:00,150,13,20,9,192,heavy,17,3,0
2021-08-12 17:30:00,116,25,33,8,182,heavy,17,3,0
2021-08-12 17:45:00,109,16,41,9,175,heavy,17,3,0
2021-08-12 18:00:00,112,11,50,5,178,heavy,18,3,0
2021-08-12 18:15:00,104,31,30,5,170,heavy,18,3,0
2021-08-12 18:30:00,146,18,40,6,210,heavy,18,3,0
2021-08-12 18:45:00,110,24,10,29,173,heavy,18,3,0
2021-08-12 19:00:00,60,15,12,25,112,normal,19,3,0
2021-08-12 19:15:00,103,9,14,29,155,normal,19,3,0
2021-08-12 19:30:00,102,6,15,6,129,normal,19,3,0
2021-08-12 19:45:00,51,17,16,8,92,normal,19,3,0
2021-08-12 20:00:00,62,12,11,18,103,low,20,3,0
2021-08-12 20:15:00,103,14,12,5,134,normal,20,3,0
2021-08-12 20:30:00,50,7,11,23,91,normal,20,3,0
2021-08-12 20:45:00,80,14,20,6,120,normal,20,3,0
2021-08-12 21:00:00,98,13,18,21,150,normal,21,3,0
2021-08-12 21:15:00,53,25,20,13,111,normal,21,3,0
2021-08-12 21:30:00,52,8,10,27,97,normal,21,3,0
2021-08-12 21:45:00,71,23,13,21,128,normal,21,3,0
2021-08-12 22:00:00,17,3,0,29,49,normal,22,3,0
2021-08-12 22:15:00,20,5,1,36,62,normal,22,3,0
2021-08-12 22:30:00,15,0,0,32,47,normal,22,3,0
2021-08-12 22:45:00,15,0,1,20,36,normal,22,3,0
2021-08-12 23:00:00,14,2,0,23,39,normal,23,3,0
2021-08-12 23:15:00,13,1,0,29,43,normal,23,3,0
2021-08-12 23:30:00,14,5,0,31,50,normal,23,3,0
2021-08-12 23:45:00,16,3,0,33,52,normal,23,3,0
2021-08-13 00:00:00,18,4,1,15,38,low,0,4,0
2021-08-13 00:15:00,20,0,1,23,44,normal,0,4,0
2021-08-13 00:30:00,19,3,0,16,38,low,0,4,0
2021-08-13 00:45:00,10,3,0,12,25,low,0,4,0
2021-08-13 01:00:00,10,4,0,23,37,normal,1,4,0
2021-08-13 01:15:00,12,5,0,29,46,normal,1,4,0
2021-08-13 01:30:00,10,0,0,39,49,normal,1,4,0
2021-08-13 01:45:00,16,2,1,21,40,normal,1,4,0
2021-08-13 02:00:00,18,4,1,36,59,normal,2,4,0
2021-08-13 02:15:00,15,1,0,14,30,low,2,4,0
2021-08-13 02:30:00,17,4,0,13,34,low,2,4,0
2021-08-13 02:45:00,18,3,1,24,46,normal,2,4,0
2021-08-13 03:00:00,19,2,0,11,32,low,3,4,0
2021-08-13 03:15:00,19,3,0,21,43,normal,3,4,0
2021-08-13 03:30:00,19,3,1,31,54,normal,3,4,0
2021-08-13 03:45:00,14,2,1,19,36,normal,3,4,0
2021-08-13 04:00:00,11,0,0,27,38,normal,4,4,0
2021-08-13 04:15:00,27,6,1,11,45,low,4,4,0
2021-08-13 04:30:00,33,11,6,13,63,low,4,4,0
2021-08-13 04:45:00,63,6,7,10,86,low,4,4,0
2021-08-13 05:00:00,58,13,4,15,90,low,5,4,0
2021-08-13 05:15:00,57,11,7,10,85,low,5,4,0
2021-08-13 05:30:00,63,10,6,12,91,low,5,4,0
2021-08-13 05:45:00,74,9,0,15,98,low,5,4,0
2021-08-13 06:00:00,71,9,7,10,97,low,6,4,0
2021-08-13 06:15:00,33,9,6,13,61,low,6,4,0
2021-08-13 06:30:00,29,6,1,12,48,low,6,4,0
2021-08-13 06:45:00,32,9,3,11,55,low,6,4,0
2021-08-13 07:00:00,57,14,3,11,85,low,7,4,0
2021-08-13 07:15:00,31,11,0,14,56,low,7,4,0
2021-08-13 07:30:00,30,9,3,10,52,low,7,4,0
2021-08-13 07:45:00,61,8,7,12,88,low,7,4,0
2021-08-13 08:00:00,47,10,4,10,71,low,8,4,0
2021-08-13 08:15:00,80,16,4,15,115,normal,8,4,0
2021-08-13 08:30:00,49,10,2,10,71,low,8,4,0
2021-08-13 08:45:00,58,7,5,13,83,low,8,4,0
2021-08-13 09:00:00,53,19,1,10,83,low,9,4,0
2021-08-13 09:15:00,132,47,25,0,204,heavy,9,4,0
2021-08-13 09:30:00,131,52,15,0,198,heavy,9,4,0
2021-08-13 09:45:00,171,59,27,3,260,heavy,9,4,0
2021-08-13 10:00:00,131,43,20,3,197,heavy,10,4,0
2021-08-13 10:15:00,177,56,12,4,249,heavy,10,4,0
2021-08-13 10:30:00,160,47,30,3,240,heavy,10,4,0
2021-08-13 10:45:00,178,68,28,4,278,heavy,10,4,0
2021-08-13 11:00:00,169,70,20,3,262,heavy,11,4,0
2021-08-13 11:15:00,133,56,25,2,216,heavy,11,4,0
2021-08-13 11:30:00,151,52,13,0,216,heavy,11,4,0
2021-08-13 11:45:00,179,46,27,3,255,heavy,11,4,0
2021-08-13 12:00:00,144,68,20,0,232,heavy,12,4,0
2021-08-13 12:15:00,162,46,19,2,229,heavy,12,4,0
2021-08-13 12:30:00,159,44,23,2,228,heavy,12,4,0
2021-08-13 12:45:00,174,67,30,1,272,heavy,12,4,0
2021-08-13 13:00:00,136,57,29,4,226,heavy,13,4,0
2021-08-13 13:15:00,156,42,12,3,213,heavy,13,4,0
2021-08-13 13:30:00,175,63,19,3,260,heavy,13,4,0
2021-08-13 13:45:00,172,62,20,2,256,heavy,13,4,0
2021-08-13 14:00:00,171,49,15,0,235,heavy,14,4,0
2021-08-13 14:15:00,172,65,18,2,257,heavy,14,4,0
2021-08-13 14:30:00,176,50,13,1,240,heavy,14,4,0
2021-08-13 14:45:00,153,50,23,3,229,heavy,14,4,0
2021-08-13 15:00:00,148,64,27,0,239,heavy,15,4,0
2021-08-13 15:15:00,56,28,6,2,92,low,15,4,0
2021-08-13 15:30:00,88,26,25,0,139,normal,15,4,0
2021-08-13 15:45:00,82,23,14,0,119,normal,15,4,0
2021-08-13 16:00:00,77,20,7,0,104,low,16,4,0
2021-08-13 16:15:00,66,24,1,0,91,low,16,4,0
2021-08-13 16:30:00,72,22,8,2,104,low,16,4,0
2021-08-13 16:45:00,62,28,21,2,113,normal,16,4,0
2021-08-13 17:00:00,66,26,4,1,97,low,17,4,0
2021-08-13 17:15:00,85,20,4,0,109,low,17,4,0
2021-08-13 17:30:00,87,24,11,2,124,normal,17,4,0
2021-08-13 17:45:00,67,28,25,0,120,normal,17,4,0
2021-08-13 18:00:00,70,26,16,2,114,normal,18,4,0
2021-08-13 18:15:00,62,20,20,1,103,normal,18,4,0
2021-08-13 18:30:00,67,29,1,0,97,low,18,4,0
2021-08-13 18:45:00,65,25,1,1,92,low,18,4,0
2021-08-13 19:00:00,76,24,23,0,123,normal,19,4,0
2021-08-13 19:15:00,42,1,5,11,59,low,19,4,0
2021-08-13 19:30:00,42,10,3,1,56,low,19,4,0
2021-08-13 19:45:00,31,11,1,12,55,low,19,4,0
2021-08-13 20:00:00,47,7,3,6,63,low,20,4,0
2021-08-13 20:15:00,28,7,2,4,41,low,20,4,0
2021-08-13 20:30:00,22,3,6,1,32,low,20,4,0
2021-08-13 20:45:00,29,1,7,5,42,low,20,4,0
2021-08-13 21:00:00,43,9,1,11,64,low,21,4,0
2021-08-13 21:15:00,23,3,3,8,37,low,21,4,0
2021-08-13 21:30:00,21,2,5,15,43,low,21,4,0
2021-08-13 21:45:00,31,2,1,9,43,low,21,4,0
2021-08-13 22:00:00,15,5,0,18,38,low,22,4,0
2021-08-13 22:15:00,11,2,0,15,28,low,22,4,0
2021-08-13 22:30:00,12,0,1,17,30,low,22,4,0
2021-08-13 22:45:00,18,3,0,18,39,low,22,4,0
2021-08-13 23:00:00,19,1,0,31,51,normal,23,4,0
2021-08-13 23:15:00,17,0,0,22,39,normal,23,4,0
2021-08-13 23:30:00,15,5,0,14,34,low,23,4,0
2021-08-13 23:45:00,15,1,1,24,41,normal,23,4,0
2021-08-14 00:00:00,18,4,0,33,55,normal,0,5,0
2021-08-14 00:15:00,14,4,0,34,52,normal,0,5,0
2021-08-14 00:30:00,14,0,1,19,34,normal,0,5,0
2021-08-14 00:45:00,19,3,0,36,58,normal,0,5,0
2021-08-14 01:00:00,10,4,1,21,36,normal,1,5,0
2021-08-14 01:15:00,19,1,0,19,39,normal,1,5,0
2021-08-14 01:30:00,18,5,0,26,49,normal,1,5,0
2021-08-14 01:45:00,17,1,1,25,44,normal,1,5,0
2021-08-14 02:00:00,20,2,0,12,34,low,2,5,0
2021-08-14 02:15:00,15,5,0,15,35,low,2,5,0
2021-08-14 02:30:00,11,4,0,14,29,low,2,5,0
2021-08-14 02:45:00,14,3,1,18,36,low,2,5,0
2021-08-14 03:00:00,13,2,0,39,54,normal,3,5,0
2021-08-14 03:15:00,17,5,0,29,51,normal,3,5,0
2021-08-14 03:30:00,13,5,0,31,49,normal,3,5,0
2021-08-14 03:45:00,18,5,0,35,58,normal,3,5,0
2021-08-14 04:00:00,15,4,0,16,35,low,4,5,0
2021-08-14 04:15:00,55,15,5,3,78,low,4,5,0
2021-08-14 04:30:00,76,10,7,9,102,low,4,5,0
2021-08-14 04:45:00,98,0,9,19,126,normal,4,5,0
2021-08-14 05:00:00,98,12,6,6,122,normal,5,5,0
2021-08-14 05:15:00,103,2,10,20,135,normal,5,5,0
2021-08-14 05:30:00,93,17,8,12,130,normal,5,5,0
2021-08-14 05:45:00,115,27,9,16,167,low,5,5,0
2021-08-14 06:00:00,120,12,22,3,157,normal,6,5,0
2021-08-14 06:15:00,142,18,27,0,187,heavy,6,5,0
2021-08-14 06:30:00,117,29,49,2,197,heavy,6,5,0
2021-08-14 06:45:00,126,36,24,0,186,heavy,6,5,0
2021-08-14 07:00:00,110,39,38,5,192,heavy,7,5,0
2021-08-14 07:15:00,149,20,39,5,213,heavy,7,5,0
2021-08-14 07:30:00,109,29,23,5,166,normal,7,5,0
2021-08-14 07:45:00,124,34,24,4,186,heavy,7,5,0
2021-08-14 08:00:00,149,35,32,1,217,heavy,8,5,0
2021-08-14 08:15:00,125,32,38,4,199,heavy,8,5,0
2021-08-14 08:30:00,101,23,38,1,163,high,8,5,0
2021-08-14 08:45:00,137,36,30,0,203,heavy,8,5,0
2021-08-14 09:00:00,139,15,21,3,178,heavy,9,5,0
2021-08-14 09:15:00,19,3,29,9,60,normal,9,5,0
2021-08-14 09:30:00,13,11,39,7,70,normal,9,5,0
2021-08-14 09:45:00,31,2,29,27,89,normal,9,5,0
2021-08-14 10:00:00,18,24,21,22,85,normal,10,5,0
2021-08-14 10:15:00,26,12,14,13,65,low,10,5,0
2021-08-14 10:30:00,31,15,13,28,87,normal,10,5,0
2021-08-14 10:45:00,12,22,8,11,53,low,10,5,0
2021-08-14 11:00:00,54,5,13,23,95,normal,11,5,0
2021-08-14 11:15:00,59,7,13,21,100,normal,11,5,0
2021-08-14 11:30:00,58,8,6,23,95,normal,11,5,0
2021-08-14 11:45:00,53,8,9,25,95,normal,11,5,0
2021-08-14 12:00:00,54,7,7,20,88,normal,12,5,0
2021-08-14 12:15:00,39,10,4,29,82,normal,12,5,0
2021-08-14 12:30:00,38,9,8,22,77,normal,12,5,0
2021-08-14 12:45:00,36,5,10,23,74,normal,12,5,0
2021-08-14 13:00:00,68,6,12,24,110,normal,13,5,0
2021-08-14 13:15:00,50,18,26,14,108,normal,13,5,0
2021-08-14 13:30:00,120,28,22,20,190,heavy,13,5,0
2021-08-14 13:45:00,60,14,28,9,111,normal,13,5,0
2021-08-14 14:00:00,105,14,8,19,146,normal,14,5,0
2021-08-14 14:15:00,89,27,18,8,142,normal,14,5,0
2021-08-14 14:30:00,28,17,31,10,86,normal,14,5,0
2021-08-14 14:45:00,79,14,23,6,122,normal,14,5,0
2021-08-14 15:00:00,15,11,30,14,70,normal,15,5,0
2021-08-14 15:15:00,77,27,23,18,145,normal,15,5,0
2021-08-14 15:30:00,19,14,24,6,63,normal,15,5,0
2021-08-14 15:45:00,79,13,28,7,127,high,15,5,0
2021-08-14 16:00:00,114,10,22,9,155,normal,16,5,0
2021-08-14 16:15:00,150,30,22,5,207,heavy,16,5,0
2021-08-14 16:30:00,142,23,25,7,197,heavy,16,5,0
2021-08-14 16:45:00,111,36,25,6,178,heavy,16,5,0
2021-08-14 17:00:00,143,37,38,8,226,heavy,17,5,0
2021-08-14 17:15:00,120,37,43,10,210,heavy,17,5,0
2021-08-14 17:30:00,147,20,49,7,223,normal,17,5,0
2021-08-14 17:45:00,140,22,27,5,194,heavy,17,5,0
2021-08-14 18:00:00,128,37,20,9,194,heavy,18,5,0
2021-08-14 18:15:00,114,23,42,10,189,heavy,18,5,0
2021-08-14 18:30:00,117,20,22,9,168,heavy,18,5,0
2021-08-14 18:45:00,93,24,17,23,157,normal,18,5,0
2021-08-14 19:00:00,65,15,15,8,103,low,19,5,0
2021-08-14 19:15:00,100,22,14,8,144,normal,19,5,0
2021-08-14 19:30:00,85,12,11,18,126,normal,19,5,0
2021-08-14 19:45:00,56,7,12,12,87,low,19,5,0
2021-08-14 20:00:00,50,12,15,18,95,low,20,5,0
2021-08-14 20:15:00,74,9,11,12,106,low,20,5,0
2021-08-14 20:30:00,73,15,18,7,113,normal,20,5,0
2021-08-14 20:45:00,99,13,20,30,162,normal,20,5,0
2021-08-14 21:00:00,110,14,17,8,149,normal,21,5,0
2021-08-14 21:15:00,82,5,12,34,133,high,21,5,0
2021-08-14 21:30:00,58,19,12,17,106,low,21,5,0
2021-08-14 21:45:00,70,10,14,32,126,high,21,5,0
2021-08-14 22:00:00,10,1,0,33,44,normal,22,5,0
2021-08-14 22:15:00,14,1,1,40,56,normal,22,5,0
2021-08-14 22:30:00,17,1,1,17,36,low,22,5,0
2021-08-14 22:45:00,12,4,1,22,39,normal,22,5,0
2021-08-14 23:00:00,15,0,0,16,31,low,23,5,0
2021-08-14 23:15:00,13,4,0,25,42,normal,23,5,0
2021-08-14 23:30:00,14,5,1,12,32,low,23,5,0
2021-08-14 23:45:00,18,1,1,35,55,normal,23,5,0
2021-08-15 00:00:00,18,5,1,19,43,normal,0,6,1
2021-08-15 00:15:00,19,3,0,38,60,normal,0,6,1
2021-08-15 00:30:00,13,0,1,12,26,low,0,6,1
2021-08-15 00:45:00,20,0,1,38,59,normal,0,6,1
2021-08-15 01:00:00,20,1,1,24,46,normal,1,6,1
2021-08-15 01:15:00,17,3,1,17,38,low,1,6,1
2021-08-15 01:30:00,12,3,1,35,51,normal,1,6,1
2021-08-15 01:45:00,19,0,1,30,50,normal,1,6,1
2021-08-15 02:00:00,19,2,1,30,52,normal,2,6,1
2021-08-15 02:15:00,18,1,0,16,35,low,2,6,1
2021-08-15 02:30:00,11,0,0,31,42,normal,2,6,1
2021-08-15 02:45:00,10,1,1,12,24,low,2,6,1
2021-08-15 03:00:00,16,1,0,24,41,normal,3,6,1
2021-08-15 03:15:00,18,3,0,28,49,normal,3,6,1
2021-08-15 03:30:00,20,1,1,39,61,normal,3,6,1
2021-08-15 03:45:00,19,3,1,27,50,normal,3,6,1
2021-08-15 04:00:00,14,1,1,34,50,normal,4,6,1
2021-08-15 04:15:00,61,26,1,16,104,low,4,6,1
2021-08-15 04:30:00,72,26,6,4,108,low,4,6,1
2021-08-15 04:45:00,86,24,3,18,131,normal,4,6,1
2021-08-15 05:00:00,75,1,8,10,94,low,5,6,1
2021-08-15 05:15:00,75,1,7,9,92,low,5,6,1
2021-08-15 05:30:00,93,5,4,1,103,low,5,6,1
2021-08-15 05:45:00,111,6,2,5,124,normal,5,6,1
2021-08-15 06:00:00,111,18,41,2,172,heavy,6,6,1
2021-08-15 06:15:00,114,27,46,0,187,heavy,6,6,1
2021-08-15 06:30:00,139,19,50,2,210,heavy,6,6,1
2021-08-15 06:45:00,109,14,38,1,162,high,6,6,1
2021-08-15 07:00:00,105,16,22,3,146,normal,7,6,1
2021-08-15 07:15:00,150,13,31,4,198,heavy,7,6,1
2021-08-15 07:30:00,122,13,47,3,185,heavy,7,6,1
2021-08-15 07:45:00,114,24,46,2,186,heavy,7,6,1
2021-08-15 08:00:00,119,36,41,0,196,heavy,8,6,1
2021-08-15 08:15:00,108,35,39,0,182,heavy,8,6,1
2021-08-15 08:30:00,113,18,28,1,160,high,8,6,1
2021-08-15 08:45:00,118,36,37,0,191,heavy,8,6,1
2021-08-15 09:00:00,113,35,48,3,199,heavy,9,6,1
2021-08-15 09:15:00,66,7,22,30,125,normal,9,6,1
2021-08-15 09:30:00,64,12,27,8,111,normal,9,6,1
2021-08-15 09:45:00,37,5,13,11,66,low,9,6,1
2021-08-15 10:00:00,82,17,31,20,150,high,10,6,1
2021-08-15 10:15:00,63,5,23,12,103,normal,10,6,1
2021-08-15 10:30:00,20,12,16,24,72,normal,10,6,1
2021-08-15 10:45:00,46,5,34,9,94,normal,10,6,1
2021-08-15 11:00:00,35,9,8,29,81,normal,11,6,1
2021-08-15 11:15:00,33,9,11,21,74,normal,11,6,1
2021-08-15 11:30:00,32,9,10,30,81,normal,11,6,1
2021-08-15 11:45:00,62,10,6,22,100,normal,11,6,1
2021-08-15 12:00:00,62,10,11,22,105,normal,12,6,1
2021-08-15 12:15:00,54,10,12,25,101,normal,12,6,1
2021-08-15 12:30:00,48,8,15,23,94,normal,12,6,1
2021-08-15 12:45:00,20,10,12,24,66,normal,12,6,1
2021-08-15 13:00:00,35,10,5,30,80,normal,13,6,1
2021-08-15 13:15:00,112,15,40,10,177,heavy,13,6,1
2021-08-15 13:30:00,51,21,25,13,110,normal,13,6,1
2021-08-15 13:45:00,53,12,23,8,96,normal,13,6,1
2021-08-15 14:00:00,63,22,18,15,118,normal,14,6,1
2021-08-15 14:15:00,50,23,16,8,97,normal,14,6,1
2021-08-15 14:30:00,94,20,35,17,166,high,14,6,1
2021-08-15 14:45:00,7,27,39,17,90,normal,14,6,1
2021-08-15 15:00:00,109,18,13,6,146,normal,15,6,1
2021-08-15 15:15:00,18,27,19,6,70,normal,15,6,1
2021-08-15 15:30:00,21,30,5,5,61,low,15,6,1
2021-08-15 15:45:00,49,16,9,12,86,low,15,6,1
2021-08-15 16:00:00,129,28,40,6,203,heavy,16,6,1
2021-08-15 16:15:00,141,18,28,8,195,heavy,16,6,1
2021-08-15 16:30:00,131,14,43,7,195,heavy,16,6,1
2021-08-15 16:45:00,105,38,23,5,171,heavy,16,6,1
2021-08-15 17:00:00,125,35,37,5,202,heavy,17,6,1
2021-08-15 17:15:00,127,36,42,9,214,heavy,17,6,1
2021-08-15 17:30:00,129,22,25,9,185,heavy,17,6,1
2021-08-15 17:45:00,121,39,47,8,215,heavy,17,6,1
2021-08-15 18:00:00,138,29,42,9,218,heavy,18,6,1
2021-08-15 18:15:00,119,26,21,5,171,heavy,18,6,1
2021-08-15 18:30:00,138,17,48,8,211,heavy,18,6,1
2021-08-15 18:45:00,72,12,14,32,130,high,18,6,1
2021-08-15 19:00:00,92,23,20,30,165,normal,19,6,1
2021-08-15 19:15:00,94,17,11,24,146,normal,19,6,1
2021-08-15 19:30:00,102,25,12,24,163,normal,19,6,1
2021-08-15 19:45:00,71,23,17,14,125,normal,19,6,1
2021-08-15 20:00:00,58,5,19,25,107,normal,20,6,1
2021-08-15 20:15:00,93,22,18,10,143,normal,20,6,1
2021-08-15 20:30:00,59,23,10,35,127,high,20,6,1
2021-08-15 20:45:00,57,20,10,20,107,normal,20,6,1
2021-08-15 21:00:00,96,9,18,25,148,normal,21,6,1
2021-08-15 21:15:00,104,12,16,20,152,normal,21,6,1
2021-08-15 21:30:00,104,22,17,23,166,normal,21,6,1
2021-08-15 21:45:00,88,8,11,29,136,normal,21,6,1
2021-08-15 22:00:00,20,3,0,16,39,low,22,6,1
2021-08-15 22:15:00,17,2,1,30,50,normal,22,6,1
2021-08-15 22:30:00,17,4,0,23,44,normal,22,6,1
2021-08-15 22:45:00,15,5,0,21,41,normal,22,6,1
2021-08-15 23:00:00,10,0,1,31,42,normal,23,6,1
2021-08-15 23:15:00,11,1,1,19,32,normal,23,6,1
2021-08-15 23:30:00,12,2,0,29,43,normal,23,6,1
2021-08-15 23:45:00,11,0,1,11,23,low,23,6,1
2021-08-16 00:00:00,18,4,1,28,51,normal,0,0,0
2021-08-16 00:15:00,13,3,0,26,42,normal,0,0,0
2021-08-16 00:30:00,16,3,0,34,53,normal,0,0,0
2021-08-16 00:45:00,16,4,0,35,55,normal,0,0,0
2021-08-16 01:00:00,20,2,1,33,56,normal,1,0,0
2021-08-16 01:15:00,14,4,1,28,47,normal,1,0,0
2021-08-16 01:30:00,11,4,1,19,35,normal,1,0,0
2021-08-16 01:45:00,19,4,0,17,40,low,1,0,0
2021-08-16 02:00:00,18,3,1,26,48,normal,2,0,0
2021-08-16 02:15:00,10,1,1,21,33,normal,2,0,0
2021-08-16 02:30:00,20,5,1,40,66,normal,2,0,0
2021-08-16 02:45:00,11,5,0,37,53,normal,2,0,0
2021-08-16 03:00:00,15,4,1,29,49,normal,3,0,0
2021-08-16 03:15:00,16,2,1,27,46,normal,3,0,0
2021-08-16 03:30:00,10,3,1,23,37,normal,3,0,0
2021-08-16 03:45:00,16,5,1,31,53,normal,3,0,0
2021-08-16 04:00:00,20,0,1,30,51,normal,4,0,0
2021-08-16 04:15:00,61,4,5,17,87,low,4,0,0
2021-08-16 04:30:00,91,8,6,2,107,low,4,0,0
2021-08-16 04:45:00,94,4,5,2,105,low,4,0,0
2021-08-16 05:00:00,117,8,6,16,147,normal,5,0,0
2021-08-16 05:15:00,111,14,10,14,149,normal,5,0,0
2021-08-16 05:30:00,91,2,3,5,101,low,5,0,0
2021-08-16 05:45:00,96,9,1,16,122,normal,5,0,0
2021-08-16 06:00:00,134,15,42,5,196,heavy,6,0,0
2021-08-16 06:15:00,121,35,39,4,199,heavy,6,0,0
2021-08-16 06:30:00,118,40,40,3,201,heavy,6,0,0
2021-08-16 06:45:00,115,17,40,1,173,heavy,6,0,0
2021-08-16 07:00:00,106,22,37,0,165,high,7,0,0
2021-08-16 07:15:00,147,26,40,0,213,heavy,7,0,0
2021-08-16 07:30:00,102,13,31,2,148,high,7,0,0
2021-08-16 07:45:00,102,12,24,3,141,normal,7,0,0
2021-08-16 08:00:00,130,40,31,2,203,heavy,8,0,0
2021-08-16 08:15:00,102,17,33,0,152,high,8,0,0
2021-08-16 08:30:00,105,13,48,5,171,heavy,8,0,0
2021-08-16 08:45:00,129,24,25,0,178,heavy,8,0,0
2021-08-16 09:00:00,117,11,45,0,173,heavy,9,0,0
2021-08-16 09:15:00,74,14,23,21,132,normal,9,0,0
2021-08-16 09:30:00,80,14,35,18,147,high,9,0,0
2021-08-16 09:45:00,31,7,34,24,96,normal,9,0,0
2021-08-16 10:00:00,18,15,9,15,57,low,10,0,0
2021-08-16 10:15:00,15,10,23,20,68,normal,10,0,0
2021-08-16 10:30:00,37,18,8,16,79,low,10,0,0
2021-08-16 10:45:00,10,7,5,14,36,low,10,0,0
2021-08-16 11:00:00,54,6,15,23,98,normal,11,0,0
2021-08-16 11:15:00,34,7,5,24,70,normal,11,0,0
2021-08-16 11:30:00,50,7,8,21,86,normal,11,0,0
2021-08-16 11:45:00,44,9,10,24,87,normal,11,0,0
2021-08-16 12:00:00,63,8,15,24,110,normal,12,0,0
2021-08-16 12:15:00,56,6,6,29,97,normal,12,0,0
2021-08-16 12:30:00,69,5,13,27,114,normal,12,0,0
2021-08-16 12:45:00,39,5,3,30,77,normal,12,0,0
2021-08-16 13:00:00,61,10,14,24,109,normal,13,0,0
2021-08-16 13:15:00,61,30,5,20,116,normal,13,0,0
2021-08-16 13:30:00,20,17,9,5,51,low,13,0,0
2021-08-16 13:45:00,70,22,38,7,137,high,13,0,0
2021-08-16 14:00:00,25,30,31,9,95,normal,14,0,0
2021-08-16 14:15:00,23,13,12,6,54,low,14,0,0
2021-08-16 14:30:00,105,30,24,8,167,normal,14,0,0
2021-08-16 14:45:00,107,10,6,6,129,normal,14,0,0
2021-08-16 15:00:00,40,20,36,7,103,normal,15,0,0
2021-08-16 15:15:00,74,18,37,11,140,high,15,0,0
2021-08-16 15:30:00,62,15,8,11,96,low,15,0,0
2021-08-16 15:45:00,81,20,14,12,127,normal,15,0,0
2021-08-16 16:00:00,111,32,43,5,191,heavy,16,0,0
2021-08-16 16:15:00,145,12,41,6,204,heavy,16,0,0
2021-08-16 16:30:00,139,11,20,7,177,heavy,16,0,0
2021-08-16 16:45:00,129,40,31,10,210,heavy,16,0,0
2021-08-16 17:00:00,128,22,28,8,186,heavy,17,0,0
2021-08-16 17:15:00,103,17,23,8,151,normal,17,0,0
2021-08-16 17:30:00,127,32,29,7,195,heavy,17,0,0
2021-08-16 17:45:00,120,35,44,8,207,heavy,17,0,0
2021-08-16 18:00:00,106,11,41,7,165,high,18,0,0
2021-08-16 18:15:00,114,40,31,5,190,heavy,18,0,0
2021-08-16 18:30:00,101,13,20,7,141,normal,18,0,0
2021-08-16 18:45:00,110,25,19,34,188,heavy,18,0,0
2021-08-16 19:00:00,108,6,17,23,154,normal,19,0,0
2021-08-16 19:15:00,104,12,10,10,136,normal,19,0,0
2021-08-16 19:30:00,102,22,17,23,164,normal,19,0,0
2021-08-16 19:45:00,77,19,16,8,120,normal,19,0,0
2021-08-16 20:00:00,70,16,19,33,138,high,20,0,0
2021-08-16 20:15:00,75,9,13,28,125,normal,20,0,0
2021-08-16 20:30:00,95,9,16,29,149,normal,20,0,0
2021-08-16 20:45:00,77,17,17,22,133,normal,20,0,0
2021-08-16 21:00:00,73,16,14,34,137,high,21,0,0
2021-08-16 21:15:00,59,7,18,12,96,normal,21,0,0
2021-08-16 21:30:00,54,20,10,9,93,low,21,0,0
2021-08-16 21:45:00,90,6,18,32,146,high,21,0,0
2021-08-16 22:00:00,15,5,1,32,53,normal,22,0,0
2021-08-16 22:15:00,12,1,0,11,24,low,22,0,0
2021-08-16 22:30:00,17,2,0,28,47,normal,22,0,0
2021-08-16 22:45:00,13,5,1,12,31,low,22,0,0
2021-08-16 23:00:00,15,5,0,21,41,normal,23,0,0
2021-08-16 23:15:00,18,4,0,11,33,low,23,0,0
2021-08-16 23:30:00,12,4,0,21,37,normal,23,0,0
2021-08-16 23:45:00,10,4,1,12,27,low,23,0,0
2021-08-17 00:00:00,15,2,0,25,42,normal,0,1,0
2021-08-17 00:15:00,11,0,0,24,35,normal,0,1,0
2021-08-17 00:30:00,15,2,1,15,33,low,0,1,0
2021-08-17 00:45:00,20,3,1,29,53,normal,0,1,0
2021-08-17 01:00:00,17,2,0,24,43,normal,1,1,0
2021-08-17 01:15:00,19,5,1,26,51,normal,1,1,0
2021-08-17 01:30:00,20,3,1,32,56,normal,1,1,0
2021-08-17 01:45:00,15,3,0,19,37,normal,1,1,0
2021-08-17 02:00:00,13,5,0,17,35,low,2,1,0
2021-08-17 02:15:00,12,5,1,19,37,normal,2,1,0
2021-08-17 02:30:00,10,2,0,27,39,normal,2,1,0
2021-08-17 02:45:00,20,4,1,23,48,normal,2,1,0
2021-08-17 03:00:00,14,0,0,16,30,low,3,1,0
2021-08-17 03:15:00,12,4,1,28,45,normal,3,1,0
2021-08-17 03:30:00,19,2,0,20,41,normal,3,1,0
2021-08-17 03:45:00,20,2,1,19,42,normal,3,1,0
2021-08-17 04:00:00,16,0,0,36,52,normal,4,1,0
2021-08-17 04:15:00,62,20,4,18,104,low,4,1,0
2021-08-17 04:30:00,50,13,2,14,79,low,4,1,0
2021-08-17 04:45:00,101,3,6,6,116,normal,4,1,0
2021-08-17 05:00:00,94,15,2,9,120,normal,5,1,0
2021-08-17 05:15:00,68,10,8,1,87,low,5,1,0
2021-08-17 05:30:00,95,3,8,20,126,normal,5,1,0
2021-08-17 05:45:00,113,7,10,16,146,normal,5,1,0
2021-08-17 06:00:00,106,13,39,1,159,high,6,1,0
2021-08-17 06:15:00,105,32,47,4,188,heavy,6,1,0
2021-08-17 06:30:00,150,19,34,4,207,heavy,6,1,0
2021-08-17 06:45:00,137,38,39,2,216,heavy,6,1,0
2021-08-17 07:00:00,113,11,32,1,157,high,7,1,0
2021-08-17 07:15:00,117,30,26,5,178,heavy,7,1,0
2021-08-17 07:30:00,130,10,37,1,178,heavy,7,1,0
2021-08-17 07:45:00,150,32,31,1,214,heavy,7,1,0
2021-08-17 08:00:00,146,10,30,3,189,heavy,8,1,0
2021-08-17 08:15:00,123,24,46,2,195,heavy,8,1,0
2021-08-17 08:30:00,110,24,26,4,164,high,8,1,0
2021-08-17 08:45:00,111,33,31,2,177,heavy,8,1,0
2021-08-17 09:00:00,132,18,32,2,184,heavy,9,1,0
2021-08-17 09:15:00,66,16,22,13,117,normal,9,1,0
2021-08-17 09:30:00,45,24,5,23,97,normal,9,1,0
2021-08-17 09:45:00,92,19,15,7,133,normal,9,1,0
2021-08-17 10:00:00,78,22,16,25,141,normal,10,1,0
2021-08-17 10:15:00,90,2,15,18,125,normal,10,1,0
2021-08-17 10:30:00,23,2,37,9,71,normal,10,1,0
2021-08-17 10:45:00,17,5,6,20,48,normal,10,1,0
2021-08-17 11:00:00,41,5,4,24,74,normal,11,1,0
2021-08-17 11:15:00,32,5,15,26,78,normal,11,1,0
2021-08-17 11:30:00,65,7,7,22,101,normal,11,1,0
2021-08-17 11:45:00,22,6,3,25,56,normal,11,1,0
2021-08-17 12:00:00,54,7,4,28,93,normal,12,1,0
2021-08-17 12:15:00,38,5,8,28,79,normal,12,1,0
2021-08-17 12:30:00,59,7,15,23,104,normal,12,1,0
2021-08-17 12:45:00,34,8,10,23,75,normal,12,1,0
2021-08-17 13:00:00,28,6,3,27,64,normal,13,1,0
2021-08-17 13:15:00,7,16,11,14,48,low,13,1,0
2021-08-17 13:30:00,8,12,22,8,50,normal,13,1,0
2021-08-17 13:45:00,42,25,38,18,123,high,13,1,0
2021-08-17 14:00:00,82,13,28,5,128,high,14,1,0
2021-08-17 14:15:00,14,24,26,9,73,normal,14,1,0
2021-08-17 14:30:00,39,25,33,9,106,normal,14,1,0
2021-08-17 14:45:00,47,14,29,6,96,normal,14,1,0
2021-08-17 15:00:00,120,20,21,18,179,heavy,15,1,0
2021-08-17 15:15:00,114,11,39,10,174,heavy,15,1,0
2021-08-17 15:30:00,99,24,30,10,163,high,15,1,0
2021-08-17 15:45:00,78,18,30,8,134,high,15,1,0
2021-08-17 16:00:00,144,40,29,10,223,normal,16,1,0
2021-08-17 16:15:00,107,28,38,9,182,heavy,16,1,0
2021-08-17 16:30:00,123,28,24,10,185,heavy,16,1,0
2021-08-17 16:45:00,126,15,28,6,175,heavy,16,1,0
2021-08-17 17:00:00,147,28,23,5,203,heavy,17,1,0
2021-08-17 17:15:00,100,21,33,7,161,high,17,1,0
2021-08-17 17:30:00,113,12,22,6,153,normal,17,1,0
2021-08-17 17:45:00,130,34,30,6,200,heavy,17,1,0
2021-08-17 18:00:00,118,40,29,10,197,heavy,18,1,0
2021-08-17 18:15:00,113,38,44,9,204,heavy,18,1,0
2021-08-17 18:30:00,117,29,29,9,184,heavy,18,1,0
2021-08-17 18:45:00,106,12,20,32,170,heavy,18,1,0
2021-08-17 19:00:00,96,11,15,14,136,normal,19,1,0
2021-08-17 19:15:00,58,11,14,24,107,normal,19,1,0
2021-08-17 19:30:00,76,22,10,9,117,normal,19,1,0
2021-08-17 19:45:00,66,6,12,33,117,high,19,1,0
2021-08-17 20:00:00,61,23,13,18,115,normal,20,1,0
2021-08-17 20:15:00,93,6,15,17,131,normal,20,1,0
2021-08-17 20:30:00,51,11,16,26,104,normal,20,1,0
2021-08-17 20:45:00,86,6,12,9,113,normal,20,1,0
2021-08-17 21:00:00,77,15,12,29,133,normal,21,1,0
2021-08-17 21:15:00,84,15,16,8,123,normal,21,1,0
2021-08-17 21:30:00,103,12,15,10,140,normal,21,1,0
2021-08-17 21:45:00,60,9,11,27,107,normal,21,1,0
2021-08-17 22:00:00,14,1,1,22,38,normal,22,1,0
2021-08-17 22:15:00,14,2,0,35,51,normal,22,1,0
2021-08-17 22:30:00,13,1,1,31,46,normal,22,1,0
2021-08-17 22:45:00,19,0,1,22,42,normal,22,1,0
2021-08-17 23:00:00,13,4,0,28,45,normal,23,1,0
2021-08-17 23:15:00,13,1,0,26,40,normal,23,1,0
2021-08-17 23:30:00,12,0,1,34,47,normal,23,1,0
2021-08-17 23:45:00,20,1,1,38,60,normal,23,1,0
2021-08-18 00:00:00,12,3,0,38,53,normal,0,2,0
2021-08-18 00:15:00,12,1,0,40,53,normal,0,2,0
2021-08-18 00:30:00,20,5,0,10,35,low,0,2,0
2021-08-18 00:45:00,12,4,1,27,44,normal,0,2,0
2021-08-18 01:00:00,15,5,0,21,41,normal,1,2,0
2021-08-18 01:15:00,19,2,0,30,51,normal,1,2,0
2021-08-18 01:30:00,11,0,1,40,52,normal,1,2,0
2021-08-18 01:45:00,15,3,0,35,53,normal,1,2,0
2021-08-18 02:00:00,15,0,1,37,53,normal,2,2,0
2021-08-18 02:15:00,16,2,0,37,55,normal,2,2,0
2021-08-18 02:30:00,10,0,1,24,35,normal,2,2,0
2021-08-18 02:45:00,12,0,1,31,44,normal,2,2,0
2021-08-18 03:00:00,15,1,1,36,53,normal,3,2,0
2021-08-18 03:15:00,14,5,0,17,36,low,3,2,0
2021-08-18 03:30:00,17,3,1,38,59,normal,3,2,0
2021-08-18 03:45:00,19,0,0,18,37,low,3,2,0
2021-08-18 04:00:00,18,5,1,30,54,normal,4,2,0
2021-08-18 04:15:00,119,12,6,4,141,normal,4,2,0
2021-08-18 04:30:00,74,28,1,13,116,normal,4,2,0
2021-08-18 04:45:00,101,26,10,0,137,normal,4,2,0
2021-08-18 05:00:00,99,4,7,19,129,normal,5,2,0
2021-08-18 05:15:00,99,18,7,5,129,normal,5,2,0
2021-08-18 05:30:00,102,24,2,8,136,normal,5,2,0
2021-08-18 05:45:00,50,4,6,13,73,low,5,2,0
2021-08-18 06:00:00,128,11,46,4,189,heavy,6,2,0
2021-08-18 06:15:00,129,39,43,0,211,heavy,6,2,0
2021-08-18 06:30:00,129,27,38,0,194,heavy,6,2,0
2021-08-18 06:45:00,113,24,22,2,161,normal,6,2,0
2021-08-18 07:00:00,141,15,21,5,182,heavy,7,2,0
2021-08-18 07:15:00,120,22,29,1,172,heavy,7,2,0
2021-08-18 07:30:00,141,24,47,4,216,heavy,7,2,0
2021-08-18 07:45:00,149,24,33,1,207,heavy,7,2,0
2021-08-18 08:00:00,140,40,36,1,217,heavy,8,2,0
2021-08-18 08:15:00,140,20,36,0,196,heavy,8,2,0
2021-08-18 08:30:00,107,13,31,4,155,high,8,2,0
2021-08-18 08:45:00,141,15,32,4,192,heavy,8,2,0
2021-08-18 09:00:00,120,27,38,4,189,heavy,9,2,0
2021-08-18 09:15:00,70,14,21,5,110,normal,9,2,0
2021-08-18 09:30:00,55,24,16,21,116,normal,9,2,0
2021-08-18 09:45:00,52,18,22,16,108,normal,9,2,0
2021-08-18 10:00:00,65,4,19,21,109,normal,10,2,0
2021-08-18 10:15:00,54,10,30,28,122,high,10,2,0
2021-08-18 10:30:00,37,3,32,18,90,normal,10,2,0
2021-08-18 10:45:00,23,3,37,18,81,normal,10,2,0
2021-08-18 11:00:00,43,7,7,29,86,normal,11,2,0
2021-08-18 11:15:00,22,6,13,24,65,normal,11,2,0
2021-08-18 11:30:00,21,10,6,30,67,normal,11,2,0
2021-08-18 11:45:00,48,8,11,22,89,normal,11,2,0
2021-08-18 12:00:00,35,5,12,20,72,normal,12,2,0
2021-08-18 12:15:00,69,5,13,22,109,normal,12,2,0
2021-08-18 12:30:00,22,9,10,21,62,normal,12,2,0
2021-08-18 12:45:00,46,5,9,23,83,normal,12,2,0
2021-08-18 13:00:00,49,5,11,21,86,normal,13,2,0
2021-08-18 13:15:00,29,18,29,20,96,normal,13,2,0
2021-08-18 13:30:00,96,23,31,14,164,high,13,2,0
2021-08-18 13:45:00,100,27,23,16,166,normal,13,2,0
2021-08-18 14:00:00,96,22,36,5,159,high,14,2,0
2021-08-18 14:15:00,27,26,25,15,93,normal,14,2,0
2021-08-18 14:30:00,114,21,32,5,172,heavy,14,2,0
2021-08-18 14:45:00,74,27,34,10,145,high,14,2,0
2021-08-18 15:00:00,14,16,9,14,53,low,15,2,0
2021-08-18 15:15:00,84,30,26,10,150,high,15,2,0
2021-08-18 15:30:00,96,19,14,18,147,normal,15,2,0
2021-08-18 15:45:00,40,15,28,5,88,normal,15,2,0
2021-08-18 16:00:00,110,15,46,5,176,heavy,16,2,0
2021-08-18 16:15:00,138,39,31,7,215,heavy,16,2,0
2021-08-18 16:30:00,118,32,32,10,192,heavy,16,2,0
2021-08-18 16:45:00,142,34,38,9,223,normal,16,2,0
2021-08-18 17:00:00,113,13,36,5,167,normal,17,2,0
2021-08-18 17:15:00,104,29,32,7,172,heavy,17,2,0
2021-08-18 17:30:00,134,39,21,9,203,heavy,17,2,0
2021-08-18 17:45:00,107,15,48,5,175,heavy,17,2,0
2021-08-18 18:00:00,139,25,43,7,214,heavy,18,2,0
2021-08-18 18:15:00,128,20,20,6,174,heavy,18,2,0
2021-08-18 18:30:00,101,13,47,10,171,heavy,18,2,0
2021-08-18 18:45:00,105,17,13,23,158,normal,18,2,0
2021-08-18 19:00:00,103,14,13,9,139,normal,19,2,0
2021-08-18 19:15:00,51,23,15,13,102,low,19,2,0
2021-08-18 19:30:00,84,10,16,20,130,normal,19,2,0
2021-08-18 19:45:00,97,25,19,24,165,normal,19,2,0
2021-08-18 20:00:00,98,8,10,19,135,normal,20,2,0
2021-08-18 20:15:00,94,13,19,25,151,normal,20,2,0
2021-08-18 20:30:00,105,25,11,35,176,heavy,20,2,0
2021-08-18 20:45:00,74,9,13,6,102,low,20,2,0
2021-08-18 21:00:00,57,18,13,28,116,normal,21,2,0
2021-08-18 21:15:00,57,14,11,33,115,high,21,2,0
2021-08-18 21:30:00,84,23,19,15,141,normal,21,2,0
2021-08-18 21:45:00,105,14,16,33,168,heavy,21,2,0
2021-08-18 22:00:00,10,4,1,38,53,normal,22,2,0
2021-08-18 22:15:00,15,1,1,29,46,normal,22,2,0
2021-08-18 22:30:00,14,1,1,25,41,normal,22,2,0
2021-08-18 22:45:00,20,2,0,37,59,normal,22,2,0
2021-08-18 23:00:00,20,1,0,27,48,normal,23,2,0
2021-08-18 23:15:00,13,1,1,18,33,low,23,2,0
2021-08-18 23:30:00,19,0,0,35,54,normal,23,2,0
2021-08-18 23:45:00,14,1,1,27,43,normal,23,2,0
2021-08-19 00:00:00,13,5,0,12,30,low,0,3,0
2021-08-19 00:15:00,18,5,0,12,35,low,0,3,0
2021-08-19 00:30:00,10,3,1,32,46,normal,0,3,0
2021-08-19 00:45:00,14,2,0,15,31,low,0,3,0
2021-08-19 01:00:00,16,3,0,15,34,low,1,3,0
2021-08-19 01:15:00,14,2,0,25,41,normal,1,3,0
2021-08-19 01:30:00,17,5,0,18,40,low,1,3,0
2021-08-19 01:45:00,13,1,0,28,42,normal,1,3,0
2021-08-19 02:00:00,19,0,1,20,40,normal,2,3,0
2021-08-19 02:15:00,15,4,0,40,59,normal,2,3,0
2021-08-19 02:30:00,14,3,1,26,44,normal,2,3,0
2021-08-19 02:45:00,15,4,0,14,33,low,2,3,0
2021-08-19 03:00:00,12,3,1,13,29,low,3,3,0
2021-08-19 03:15:00,12,4,0,31,47,normal,3,3,0
2021-08-19 03:30:00,17,4,1,20,42,normal,3,3,0
2021-08-19 03:45:00,12,0,1,13,26,low,3,3,0
2021-08-19 04:00:00,18,2,0,16,36,low,4,3,0
2021-08-19 04:15:00,115,16,10,13,154,normal,4,3,0
2021-08-19 04:30:00,117,5,10,15,147,normal,4,3,0
2021-08-19 04:45:00,92,26,8,7,133,normal,4,3,0
2021-08-19 05:00:00,88,3,6,4,101,low,5,3,0
2021-08-19 05:15:00,109,11,4,3,127,normal,5,3,0
2021-08-19 05:30:00,81,4,0,20,105,normal,5,3,0
2021-08-19 05:45:00,118,2,5,19,144,normal,5,3,0
2021-08-19 06:00:00,107,26,31,2,166,high,6,3,0
2021-08-19 06:15:00,103,11,35,5,154,high,6,3,0
2021-08-19 06:30:00,145,13,33,3,194,heavy,6,3,0
2021-08-19 06:45:00,143,22,37,4,206,heavy,6,3,0
2021-08-19 07:00:00,113,38,50,3,204,heavy,7,3,0
2021-08-19 07:15:00,149,10,47,3,209,heavy,7,3,0
2021-08-19 07:30:00,132,33,35,2,202,heavy,7,3,0
2021-08-19 07:45:00,119,40,41,2,202,heavy,7,3,0
2021-08-19 08:00:00,133,31,27,2,193,heavy,8,3,0
2021-08-19 08:15:00,140,20,44,4,208,heavy,8,3,0
2021-08-19 08:30:00,140,34,31,1,206,heavy,8,3,0
2021-08-19 08:45:00,128,37,50,2,217,heavy,8,3,0
2021-08-19 09:00:00,132,11,24,3,170,heavy,9,3,0
2021-08-19 09:15:00,23,8,40,27,98,normal,9,3,0
2021-08-19 09:30:00,75,2,18,29,124,normal,9,3,0
2021-08-19 09:45:00,99,14,33,14,160,high,9,3,0
2021-08-19 10:00:00,10,1,13,7,31,low,10,3,0
2021-08-19 10:15:00,74,21,29,26,150,high,10,3,0
2021-08-19 10:30:00,29,15,25,5,74,normal,10,3,0
2021-08-19 10:45:00,50,17,38,24,129,high,10,3,0
2021-08-19 11:00:00,64,9,14,20,107,normal,11,3,0
2021-08-19 11:15:00,49,5,10,21,85,normal,11,3,0
2021-08-19 11:30:00,39,7,10,30,86,normal,11,3,0
2021-08-19 11:45:00,68,5,5,24,102,normal,11,3,0
2021-08-19 12:00:00,67,7,8,22,104,normal,12,3,0
2021-08-19 12:15:00,47,8,3,25,83,normal,12,3,0
2021-08-19 12:30:00,66,9,7,24,106,normal,12,3,0
2021-08-19 12:45:00,46,8,3,22,79,normal,12,3,0
2021-08-19 13:00:00,54,6,12,21,93,normal,13,3,0
2021-08-19 13:15:00,18,16,32,18,84,normal,13,3,0
2021-08-19 13:30:00,24,20,7,9,60,low,13,3,0
2021-08-19 13:45:00,113,17,16,20,166,normal,13,3,0
2021-08-19 14:00:00,52,13,15,10,90,low,14,3,0
2021-08-19 14:15:00,58,26,25,18,127,normal,14,3,0
2021-08-19 14:30:00,44,19,22,6,91,normal,14,3,0
2021-08-19 14:45:00,8,26,34,9,77,normal,14,3,0
2021-08-19 15:00:00,31,10,27,8,76,normal,15,3,0
2021-08-19 15:15:00,115,24,16,5,160,normal,15,3,0
2021-08-19 15:30:00,56,29,16,16,117,normal,15,3,0
2021-08-19 15:45:00,7,12,33,12,64,normal,15,3,0
2021-08-19 16:00:00,133,10,46,10,199,heavy,16,3,0
2021-08-19 16:15:00,104,31,37,6,178,heavy,16,3,0
2021-08-19 16:30:00,100,38,36,9,183,heavy,16,3,0
2021-08-19 16:45:00,127,25,37,5,194,heavy,16,3,0
2021-08-19 17:00:00,118,32,48,6,204,heavy,17,3,0
2021-08-19 17:15:00,147,19,31,8,205,heavy,17,3,0
2021-08-19 17:30:00,123,36,34,5,198,heavy,17,3,0
2021-08-19 17:45:00,111,24,25,5,165,normal,17,3,0
2021-08-19 18:00:00,121,16,42,8,187,heavy,18,3,0
2021-08-19 18:15:00,119,38,47,7,211,heavy,18,3,0
2021-08-19 18:30:00,132,30,41,6,209,heavy,18,3,0
2021-08-19 18:45:00,52,6,12,18,88,low,18,3,0
2021-08-19 19:00:00,97,21,10,8,136,normal,19,3,0
2021-08-19 19:15:00,50,16,20,31,117,high,19,3,0
2021-08-19 19:30:00,94,25,19,8,146,normal,19,3,0
2021-08-19 19:45:00,66,11,18,34,129,high,19,3,0
2021-08-19 20:00:00,105,16,15,6,142,normal,20,3,0
2021-08-19 20:15:00,56,23,10,18,107,low,20,3,0
2021-08-19 20:30:00,105,19,10,25,159,normal,20,3,0
2021-08-19 20:45:00,60,18,11,16,105,low,20,3,0
2021-08-19 21:00:00,88,10,14,11,123,normal,21,3,0
2021-08-19 21:15:00,110,6,14,23,153,normal,21,3,0
2021-08-19 21:30:00,78,20,11,35,144,high,21,3,0
2021-08-19 21:45:00,105,14,10,7,136,normal,21,3,0
2021-08-19 22:00:00,18,1,0,10,29,low,22,3,0
2021-08-19 22:15:00,18,1,0,27,46,normal,22,3,0
2021-08-19 22:30:00,12,4,1,18,35,low,22,3,0
2021-08-19 22:45:00,15,4,1,32,52,normal,22,3,0
2021-08-19 23:00:00,13,4,0,32,49,normal,23,3,0
2021-08-19 23:15:00,14,4,0,15,33,low,23,3,0
2021-08-19 23:30:00,15,4,0,17,36,low,23,3,0
2021-08-19 23:45:00,14,0,1,21,36,normal,23,3,0
2021-08-20 00:00:00,17,5,0,37,59,normal,0,4,0
2021-08-20 00:15:00,14,4,1,12,31,low,0,4,0
2021-08-20 00:30:00,16,2,0,15,33,low,0,4,0
2021-08-20 00:45:00,13,4,1,14,32,low,0,4,0
2021-08-20 01:00:00,12,4,0,29,45,normal,1,4,0
2021-08-20 01:15:00,19,4,1,30,54,normal,1,4,0
2021-08-20 01:30:00,18,4,0,18,40,low,1,4,0
2021-08-20 01:45:00,18,1,1,12,32,low,1,4,0
2021-08-20 02:00:00,20,4,1,21,46,normal,2,4,0
2021-08-20 02:15:00,10,2,1,20,33,normal,2,4,0
2021-08-20 02:30:00,18,5,1,23,47,normal,2,4,0
2021-08-20 02:45:00,16,5,1,30,52,normal,2,4,0
2021-08-20 03:00:00,12,3,0,40,55,normal,3,4,0
2021-08-20 03:15:00,12,2,0,40,54,normal,3,4,0
2021-08-20 03:30:00,16,0,1,37,54,normal,3,4,0
2021-08-20 03:45:00,15,4,1,16,36,low,3,4,0
2021-08-20 04:00:00,13,0,0,38,51,normal,4,4,0
2021-08-20 04:15:00,61,5,3,14,83,low,4,4,0
2021-08-20 04:30:00,27,15,6,10,58,low,4,4,0
2021-08-20 04:45:00,74,11,5,15,105,low,4,4,0
2021-08-20 05:00:00,70,6,7,14,97,low,5,4,0
2021-08-20 05:15:00,33,6,0,11,50,low,5,4,0
2021-08-20 05:30:00,29,12,1,13,55,low,5,4,0
2021-08-20 05:45:00,69,5,7,10,91,low,5,4,0
2021-08-20 06:00:00,41,16,7,15,79,low,6,4,0
2021-08-20 06:15:00,35,11,5,11,62,low,6,4,0
2021-08-20 06:30:00,25,9,6,14,54,low,6,4,0
2021-08-20 06:45:00,65,15,1,11,92,low,6,4,0
2021-08-20 07:00:00,66,6,3,14,89,low,7,4,0
2021-08-20 07:15:00,27,6,5,15,53,low,7,4,0
2021-08-20 07:30:00,75,6,1,10,92,low,7,4,0
2021-08-20 07:45:00,54,11,4,12,81,low,7,4,0
2021-08-20 08:00:00,54,18,3,12,87,low,8,4,0
2021-08-20 08:15:00,69,8,0,14,91,low,8,4,0
2021-08-20 08:30:00,52,19,6,10,87,low,8,4,0
2021-08-20 08:45:00,66,8,0,12,86,low,8,4,0
2021-08-20 09:00:00,54,11,0,13,78,low,9,4,0
2021-08-20 09:15:00,151,48,15,3,217,heavy,9,4,0
2021-08-20 09:30:00,170,62,18,2,252,heavy,9,4,0
2021-08-20 09:45:00,134,59,11,3,207,heavy,9,4,0
2021-08-20 10:00:00,166,63,22,1,252,heavy,10,4,0
2021-08-20 10:15:00,173,64,10,2,249,heavy,10,4,0
2021-08-20 10:30:00,176,45,22,2,245,heavy,10,4,0
2021-08-20 10:45:00,162,59,27,1,249,heavy,10,4,0
2021-08-20 11:00:00,171,46,15,3,235,heavy,11,4,0
2021-08-20 11:15:00,158,44,26,2,230,heavy,11,4,0
2021-08-20 11:30:00,151,64,16,0,231,heavy,11,4,0
2021-08-20 11:45:00,162,65,14,3,244,heavy,11,4,0
2021-08-20 12:00:00,179,44,23,1,247,heavy,12,4,0
2021-08-20 12:15:00,175,59,11,3,248,heavy,12,4,0
2021-08-20 12:30:00,173,63,13,2,251,heavy,12,4,0
2021-08-20 12:45:00,144,66,11,3,224,heavy,12,4,0
2021-08-20 13:00:00,132,68,22,4,226,heavy,13,4,0
2021-08-20 13:15:00,161,50,10,0,221,heavy,13,4,0
2021-08-20 13:30:00,151,56,29,1,237,heavy,13,4,0
2021-08-20 13:45:00,168,59,24,1,252,heavy,13,4,0
2021-08-20 14:00:00,144,65,20,3,232,heavy,14,4,0
2021-08-20 14:15:00,179,63,12,2,256,heavy,14,4,0
2021-08-20 14:30:00,161,56,12,4,233,heavy,14,4,0
2021-08-20 14:45:00,134,67,12,1,214,heavy,14,4,0
2021-08-20 15:00:00,140,70,23,4,237,heavy,15,4,0
2021-08-20 15:15:00,66,29,24,1,120,normal,15,4,0
2021-08-20 15:30:00,60,27,17,2,106,normal,15,4,0
2021-08-20 15:45:00,89,27,10,2,128,normal,15,4,0
2021-08-20 16:00:00,81,29,5,0,115,normal,16,4,0
2021-08-20 16:15:00,78,22,12,1,113,normal,16,4,0
2021-08-20 16:30:00,71,24,18,2,115,normal,16,4,0
2021-08-20 16:45:00,50,26,9,1,86,low,16,4,0
2021-08-20 17:00:00,55,28,5,0,88,low,17,4,0
2021-08-20 17:15:00,61,20,25,1,107,normal,17,4,0
2021-08-20 17:30:00,76,22,14,2,114,normal,17,4,0
2021-08-20 17:45:00,50,20,23,1,94,normal,17,4,0
2021-08-20 18:00:00,89,26,0,2,117,normal,18,4,0
2021-08-20 18:15:00,62,20,17,0,99,normal,18,4,0
2021-08-20 18:30:00,83,20,23,2,128,normal,18,4,0
2021-08-20 18:45:00,65,20,2,0,87,low,18,4,0
2021-08-20 19:00:00,60,21,2,1,84,low,19,4,0
2021-08-20 19:15:00,36,8,3,9,56,low,19,4,0
2021-08-20 19:30:00,39,5,4,11,59,low,19,4,0
2021-08-20 19:45:00,26,8,3,0,37,low,19,4,0
2021-08-20 20:00:00,23,4,0,5,32,low,20,4,0
2021-08-20 20:15:00,50,2,0,4,56,low,20,4,0
2021-08-20 20:30:00,30,2,3,1,36,low,20,4,0
2021-08-20 20:45:00,48,10,4,2,64,low,20,4,0
2021-08-20 21:00:00,39,6,6,1,52,low,21,4,0
2021-08-20 21:15:00,47,10,3,9,69,low,21,4,0
2021-08-20 21:30:00,26,3,5,3,37,low,21,4,0
2021-08-20 21:45:00,25,6,3,9,43,low,21,4,0
2021-08-20 22:00:00,19,1,0,11,31,low,22,4,0
2021-08-20 22:15:00,16,5,0,26,47,normal,22,4,0
2021-08-20 22:30:00,15,2,1,39,57,normal,22,4,0
2021-08-20 22:45:00,14,5,0,11,30,low,22,4,0
2021-08-20 23:00:00,12,2,0,20,34,normal,23,4,0
2021-08-20 23:15:00,11,2,0,35,48,normal,23,4,0
2021-08-20 23:30:00,18,5,1,11,35,low,23,4,0
2021-08-20 23:45:00,17,2,0,20,39,normal,23,4,0
2021-08-21 00:00:00,19,5,1,30,55,normal,0,5,0
2021-08-21 00:15:00,17,4,1,24,46,normal,0,5,0
2021-08-21 00:30:00,16,3,0,14,33,low,0,5,0
2021-08-21 00:45:00,16,3,1,23,43,normal,0,5,0
2021-08-21 01:00:00,20,0,1,17,38,low,1,5,0
2021-08-21 01:15:00,20,0,0,37,57,normal,1,5,0
2021-08-21 01:30:00,18,0,1,30,49,normal,1,5,0
2021-08-21 01:45:00,19,1,0,14,34,low,1,5,0
2021-08-21 02:00:00,18,5,0,29,52,normal,2,5,0
2021-08-21 02:15:00,11,1,0,22,34,normal,2,5,0
2021-08-21 02:30:00,20,3,0,24,47,normal,2,5,0
2021-08-21 02:45:00,12,2,1,10,25,low,2,5,0
2021-08-21 03:00:00,19,5,1,31,56,normal,3,5,0
2021-08-21 03:15:00,10,0,0,32,42,normal,3,5,0
2021-08-21 03:30:00,14,1,1,12,28,low,3,5,0
2021-08-21 03:45:00,14,2,1,24,41,normal,3,5,0
2021-08-21 04:00:00,10,3,0,32,45,normal,4,5,0
2021-08-21 04:15:00,97,23,6,17,143,normal,4,5,0
2021-08-21 04:30:00,104,22,7,11,144,normal,4,5,0
2021-08-21 04:45:00,100,15,8,20,143,normal,4,5,0
2021-08-21 05:00:00,87,7,7,4,105,low,5,5,0
2021-08-21 05:15:00,77,27,8,10,122,normal,5,5,0
2021-08-21 05:30:00,51,7,4,5,67,low,5,5,0
2021-08-21 05:45:00,79,1,10,6,96,low,5,5,0
2021-08-21 06:00:00,100,40,29,5,174,heavy,6,5,0
2021-08-21 06:15:00,112,13,39,0,164,high,6,5,0
2021-08-21 06:30:00,120,16,34,2,172,heavy,6,5,0
2021-08-21 06:45:00,123,14,26,3,166,high,6,5,0
2021-08-21 07:00:00,142,27,27,4,200,heavy,7,5,0
2021-08-21 07:15:00,139,38,49,2,228,heavy,7,5,0
2021-08-21 07:30:00,134,24,21,2,181,heavy,7,5,0
2021-08-21 07:45:00,102,13,31,0,146,high,7,5,0
2021-08-21 08:00:00,102,16,43,4,165,high,8,5,0
2021-08-21 08:15:00,106,16,32,1,155,high,8,5,0
2021-08-21 08:30:00,117,19,42,3,181,heavy,8,5,0
2021-08-21 08:45:00,139,36,40,3,218,heavy,8,5,0
2021-08-21 09:00:00,121,13,25,2,161,normal,9,5,0
2021-08-21 09:15:00,65,19,16,11,111,normal,9,5,0
2021-08-21 09:30:00,12,25,39,28,104,normal,9,5,0
2021-08-21 09:45:00,98,21,10,5,134,normal,9,5,0
2021-08-21 10:00:00,58,9,25,13,105,normal,10,5,0
2021-08-21 10:15:00,81,10,39,29,159,high,10,5,0
2021-08-21 10:30:00,67,20,33,29,149,high,10,5,0
2021-08-21 10:45:00,68,22,25,16,131,normal,10,5,0
2021-08-21 11:00:00,47,10,6,22,85,normal,11,5,0
2021-08-21 11:15:00,45,7,10,27,89,normal,11,5,0
2021-08-21 11:30:00,54,5,11,24,94,normal,11,5,0
2021-08-21 11:45:00,61,7,15,28,111,normal,11,5,0
2021-08-21 12:00:00,56,5,4,29,94,normal,12,5,0
2021-08-21 12:15:00,23,5,4,27,59,normal,12,5,0
2021-08-21 12:30:00,31,6,8,23,68,normal,12,5,0
2021-08-21 12:45:00,27,7,14,28,76,normal,12,5,0
2021-08-21 13:00:00,30,7,3,30,70,normal,13,5,0
2021-08-21 13:15:00,114,21,5,14,154,normal,13,5,0
2021-08-21 13:30:00,46,24,35,16,121,high,13,5,0
2021-08-21 13:45:00,68,29,29,20,146,high,13,5,0
2021-08-21 14:00:00,45,16,15,5,81,low,14,5,0
2021-08-21 14:15:00,86,13,11,20,130,normal,14,5,0
2021-08-21 14:30:00,44,11,19,15,89,normal,14,5,0
2021-08-21 14:45:00,45,17,13,20,95,normal,14,5,0
2021-08-21 15:00:00,106,17,7,12,142,normal,15,5,0
2021-08-21 15:15:00,44,16,9,13,82,low,15,5,0
2021-08-21 15:30:00,77,23,13,9,122,normal,15,5,0
2021-08-21 15:45:00,53,17,26,8,104,normal,15,5,0
2021-08-21 16:00:00,138,18,20,8,184,heavy,16,5,0
2021-08-21 16:15:00,142,24,39,9,214,heavy,16,5,0
2021-08-21 16:30:00,114,25,21,7,167,normal,16,5,0
2021-08-21 16:45:00,116,35,42,6,199,heavy,16,5,0
2021-08-21 17:00:00,149,22,37,8,216,heavy,17,5,0
2021-08-21 17:15:00,100,12,39,7,158,high,17,5,0
2021-08-21 17:30:00,101,23,45,5,174,heavy,17,5,0
2021-08-21 17:45:00,122,40,48,10,220,heavy,17,5,0
2021-08-21 18:00:00,112,34,39,9,194,heavy,18,5,0
2021-08-21 18:15:00,112,12,41,5,170,heavy,18,5,0
2021-08-21 18:30:00,116,22,23,7,168,heavy,18,5,0
2021-08-21 18:45:00,90,13,15,33,151,high,18,5,0
2021-08-21 19:00:00,85,14,14,13,126,normal,19,5,0
2021-08-21 19:15:00,59,25,13,27,124,normal,19,5,0
2021-08-21 19:30:00,108,5,15,22,150,normal,19,5,0
2021-08-21 19:45:00,75,8,16,25,124,normal,19,5,0
2021-08-21 20:00:00,96,15,12,27,150,normal,20,5,0
2021-08-21 20:15:00,61,17,10,8,96,low,20,5,0
2021-08-21 20:30:00,84,25,20,30,159,normal,20,5,0
2021-08-21 20:45:00,55,9,12,19,95,normal,20,5,0
2021-08-21 21:00:00,65,16,12,32,125,high,21,5,0
2021-08-21 21:15:00,87,16,10,16,129,normal,21,5,0
2021-08-21 21:30:00,75,5,12,21,113,normal,21,5,0
2021-08-21 21:45:00,82,16,14,34,146,high,21,5,0
2021-08-21 22:00:00,11,3,0,34,48,normal,22,5,0
2021-08-21 22:15:00,15,5,0,14,34,low,22,5,0
2021-08-21 22:30:00,18,5,1,13,37,low,22,5,0
2021-08-21 22:45:00,19,2,1,34,56,normal,22,5,0
2021-08-21 23:00:00,20,4,1,26,51,normal,23,5,0
2021-08-21 23:15:00,14,4,0,10,28,low,23,5,0
2021-08-21 23:30:00,11,1,1,36,49,normal,23,5,0
2021-08-21 23:45:00,10,2,1,15,28,low,23,5,0
2021-08-22 00:00:00,10,3,0,33,46,normal,0,6,1
2021-08-22 00:15:00,14,3,0,23,40,normal,0,6,1
2021-08-22 00:30:00,11,5,1,11,28,low,0,6,1
2021-08-22 00:45:00,10,1,1,34,46,normal,0,6,1
2021-08-22 01:00:00,20,4,1,17,42,low,1,6,1
2021-08-22 01:15:00,17,5,0,24,46,normal,1,6,1
2021-08-22 01:30:00,12,2,1,18,33,low,1,6,1
2021-08-22 01:45:00,15,0,1,16,32,low,1,6,1
2021-08-22 02:00:00,19,5,0,15,39,low,2,6,1
2021-08-22 02:15:00,11,3,1,39,54,normal,2,6,1
2021-08-22 02:30:00,14,5,0,10,29,low,2,6,1
2021-08-22 02:45:00,20,0,1,33,54,normal,2,6,1
2021-08-22 03:00:00,13,1,1,33,48,normal,3,6,1
2021-08-22 03:15:00,18,2,1,12,33,low,3,6,1
2021-08-22 03:30:00,19,2,1,23,45,normal,3,6,1
2021-08-22 03:45:00,10,4,0,36,50,normal,3,6,1
2021-08-22 04:00:00,13,4,0,17,34,low,4,6,1
2021-08-22 04:15:00,86,28,2,18,134,normal,4,6,1
2021-08-22 04:30:00,59,29,9,14,111,low,4,6,1
2021-08-22 04:45:00,102,20,9,13,144,normal,4,6,1
2021-08-22 05:00:00,114,28,8,16,166,normal,5,6,1
2021-08-22 05:15:00,87,23,5,0,115,normal,5,6,1
2021-08-22 05:30:00,88,5,8,13,114,normal,5,6,1
2021-08-22 05:45:00,83,6,4,9,102,low,5,6,1
2021-08-22 06:00:00,150,19,24,3,196,heavy,6,6,1
2021-08-22 06:15:00,148,35,46,1,230,heavy,6,6,1
2021-08-22 06:30:00,146,23,23,4,196,heavy,6,6,1
2021-08-22 06:45:00,140,21,39,3,203,heavy,6,6,1
2021-08-22 07:00:00,149,36,35,1,221,heavy,7,6,1
2021-08-22 07:15:00,125,34,42,0,201,heavy,7,6,1
2021-08-22 07:30:00,147,34,20,5,206,heavy,7,6,1
2021-08-22 07:45:00,128,33,21,4,186,heavy,7,6,1
2021-08-22 08:00:00,111,38,50,5,204,heavy,8,6,1
2021-08-22 08:15:00,144,20,32,4,200,heavy,8,6,1
2021-08-22 08:30:00,121,14,23,1,159,normal,8,6,1
2021-08-22 08:45:00,136,36,40,4,216,heavy,8,6,1
2021-08-22 09:00:00,114,21,23,1,159,normal,9,6,1
2021-08-22 09:15:00,75,17,37,29,158,high,9,6,1
2021-08-22 09:30:00,34,5,27,22,88,normal,9,6,1
2021-08-22 09:45:00,45,6,7,15,73,low,9,6,1
2021-08-22 10:00:00,65,10,6,27,108,normal,10,6,1
2021-08-22 10:15:00,67,25,20,18,130,normal,10,6,1
2021-08-22 10:30:00,50,25,25,28,128,normal,10,6,1
2021-08-22 10:45:00,37,19,38,12,106,normal,10,6,1
2021-08-22 11:00:00,36,8,3,29,76,normal,11,6,1
2021-08-22 11:15:00,63,5,8,23,99,normal,11,6,1
2021-08-22 11:30:00,67,5,7,22,101,normal,11,6,1
2021-08-22 11:45:00,36,9,14,22,81,normal,11,6,1
2021-08-22 12:00:00,57,8,10,22,97,normal,12,6,1
2021-08-22 12:15:00,65,7,14,25,111,normal,12,6,1
2021-08-22 12:30:00,54,10,3,29,96,normal,12,6,1
2021-08-22 12:45:00,41,5,4,25,75,normal,12,6,1
2021-08-22 13:00:00,43,9,3,25,80,normal,13,6,1
2021-08-22 13:15:00,9,27,32,17,85,normal,13,6,1
2021-08-22 13:30:00,101,28,18,20,167,normal,13,6,1
2021-08-22 13:45:00,99,16,16,18,149,normal,13,6,1
2021-08-22 14:00:00,20,27,32,12,91,normal,14,6,1
2021-08-22 14:15:00,96,16,39,17,168,heavy,14,6,1
2021-08-22 14:30:00,62,28,18,20,128,normal,14,6,1
2021-08-22 14:45:00,58,27,17,5,107,normal,14,6,1
2021-08-22 15:00:00,60,18,28,12,118,high,15,6,1
2021-08-22 15:15:00,81,26,13,17,137,normal,15,6,1
2021-08-22 15:30:00,118,15,27,13,173,heavy,15,6,1
2021-08-22 15:45:00,53,12,25,20,110,normal,15,6,1
2021-08-22 16:00:00,132,12,27,9,180,heavy,16,6,1
2021-08-22 16:15:00,149,14,50,5,218,heavy,16,6,1
2021-08-22 16:30:00,106,35,41,5,187,heavy,16,6,1
2021-08-22 16:45:00,150,29,27,7,213,heavy,16,6,1
2021-08-22 17:00:00,110,30,46,5,191,heavy,17,6,1
2021-08-22 17:15:00,129,35,34,5,203,heavy,17,6,1
2021-08-22 17:30:00,133,21,26,5,185,heavy,17,6,1
2021-08-22 17:45:00,148,34,45,7,234,heavy,17,6,1
2021-08-22 18:00:00,144,39,43,8,234,heavy,18,6,1
2021-08-22 18:15:00,126,27,44,8,205,heavy,18,6,1
2021-08-22 18:30:00,103,34,49,5,191,heavy,18,6,1
2021-08-22 18:45:00,96,7,13,30,146,normal,18,6,1
2021-08-22 19:00:00,54,17,17,19,107,normal,19,6,1
2021-08-22 19:15:00,98,16,17,15,146,normal,19,6,1
2021-08-22 19:30:00,72,6,19,8,105,normal,19,6,1
2021-08-22 19:45:00,69,23,12,31,135,high,19,6,1
2021-08-22 20:00:00,85,13,16,24,138,normal,20,6,1
2021-08-22 20:15:00,102,22,12,9,145,normal,20,6,1
2021-08-22 20:30:00,103,14,20,14,151,normal,20,6,1
2021-08-22 20:45:00,80,12,10,22,124,normal,20,6,1
2021-08-22 21:00:00,63,18,11,5,97,low,21,6,1
2021-08-22 21:15:00,84,21,13,9,127,normal,21,6,1
2021-08-22 21:30:00,72,10,10,29,121,normal,21,6,1
2021-08-22 21:45:00,79,22,17,13,131,normal,21,6,1
2021-08-22 22:00:00,12,5,0,27,44,normal,22,6,1
2021-08-22 22:15:00,19,1,1,38,59,normal,22,6,1
2021-08-22 22:30:00,14,3,0,33,50,normal,22,6,1
2021-08-22 22:45:00,16,3,1,37,57,normal,22,6,1
2021-08-22 23:00:00,14,5,0,37,56,normal,23,6,1
2021-08-22 23:15:00,11,2,1,20,34,normal,23,6,1
2021-08-22 23:30:00,20,3,0,25,48,normal,23,6,1
2021-08-22 23:45:00,20,0,1,30,51,normal,23,6,1
2021-08-23 00:00:00,13,2,1,17,33,low,0,0,0
2021-08-23 00:15:00,20,1,1,19,41,normal,0,0,0
2021-08-23 00:30:00,10,2,1,12,25,low,0,0,0
2021-08-23 00:45:00,14,2,0,25,41,normal,0,0,0
2021-08-23 01:00:00,12,0,1,16,29,low,1,0,0
2021-08-23 01:15:00,11,5,1,31,48,normal,1,0,0
2021-08-23 01:30:00,13,1,1,16,31,low,1,0,0
2021-08-23 01:45:00,17,3,0,10,30,low,1,0,0
2021-08-23 02:00:00,11,1,0,22,34,normal,2,0,0
2021-08-23 02:15:00,10,4,1,16,31,low,2,0,0
2021-08-23 02:30:00,15,3,1,32,51,normal,2,0,0
2021-08-23 02:45:00,10,0,0,22,32,normal,2,0,0
2021-08-23 03:00:00,20,1,1,16,38,low,3,0,0
2021-08-23 03:15:00,16,1,1,15,33,low,3,0,0
2021-08-23 03:30:00,14,4,1,32,51,normal,3,0,0
2021-08-23 03:45:00,16,1,1,37,55,normal,3,0,0
2021-08-23 04:00:00,10,2,1,36,49,normal,4,0,0
2021-08-23 04:15:00,96,18,7,2,123,normal,4,0,0
2021-08-23 04:30:00,51,14,0,5,70,low,4,0,0
2021-08-23 04:45:00,63,25,2,8,98,low,4,0,0
2021-08-23 05:00:00,72,7,1,4,84,low,5,0,0
2021-08-23 05:15:00,86,18,6,1,111,low,5,0,0
2021-08-23 05:30:00,105,4,4,20,133,normal,5,0,0
2021-08-23 05:45:00,117,10,10,18,155,normal,5,0,0
2021-08-23 06:00:00,120,36,32,0,188,heavy,6,0,0
2021-08-23 06:15:00,135,20,31,0,186,heavy,6,0,0
2021-08-23 06:30:00,112,40,42,3,197,heavy,6,0,0
2021-08-23 06:45:00,135,13,20,3,171,heavy,6,0,0
2021-08-23 07:00:00,105,35,24,2,166,normal,7,0,0
2021-08-23 07:15:00,150,25,36,0,211,heavy,7,0,0
2021-08-23 07:30:00,108,27,23,2,160,normal,7,0,0
2021-08-23 07:45:00,108,40,45,1,194,heavy,7,0,0
2021-08-23 08:00:00,118,19,21,1,159,normal,8,0,0
2021-08-23 08:15:00,131,18,41,1,191,heavy,8,0,0
2021-08-23 08:30:00,148,31,20,4,203,heavy,8,0,0
2021-08-23 08:45:00,120,26,22,1,169,heavy,8,0,0
2021-08-23 09:00:00,147,12,32,0,191,heavy,9,0,0
2021-08-23 09:15:00,73,9,35,12,129,high,9,0,0
2021-08-23 09:30:00,93,21,22,29,165,normal,9,0,0
2021-08-23 09:45:00,66,2,10,28,106,normal,9,0,0
2021-08-23 10:00:00,18,6,6,6,36,low,10,0,0
2021-08-23 10:15:00,78,1,16,30,125,normal,10,0,0
2021-08-23 10:30:00,69,15,24,20,128,normal,10,0,0
2021-08-23 10:45:00,82,2,40,17,141,high,10,0,0
2021-08-23 11:00:00,57,9,5,23,94,normal,11,0,0
2021-08-23 11:15:00,25,5,14,26,70,normal,11,0,0
2021-08-23 11:30:00,40,9,15,28,92,normal,11,0,0
2021-08-23 11:45:00,52,6,13,21,92,normal,11,0,0
2021-08-23 12:00:00,45,8,13,29,95,normal,12,0,0
2021-08-23 12:15:00,67,10,7,25,109,normal,12,0,0
2021-08-23 12:30:00,20,8,14,30,72,normal,12,0,0
2021-08-23 12:45:00,44,8,4,29,85,normal,12,0,0
2021-08-23 13:00:00,63,5,8,29,105,normal,13,0,0
2021-08-23 13:15:00,119,15,20,13,167,normal,13,0,0
2021-08-23 13:30:00,103,10,23,7,143,normal,13,0,0
2021-08-23 13:45:00,42,14,15,14,85,low,13,0,0
2021-08-23 14:00:00,67,20,24,12,123,normal,14,0,0
2021-08-23 14:15:00,56,18,29,17,120,high,14,0,0
2021-08-23 14:30:00,65,16,32,15,128,high,14,0,0
2021-08-23 14:45:00,107,11,26,19,163,high,14,0,0
2021-08-23 15:00:00,11,18,22,10,61,normal,15,0,0
2021-08-23 15:15:00,28,15,27,12,82,normal,15,0,0
2021-08-23 15:30:00,45,17,7,6,75,low,15,0,0
2021-08-23 15:45:00,66,12,27,6,111,normal,15,0,0
2021-08-23 16:00:00,104,40,22,9,175,heavy,16,0,0
2021-08-23 16:15:00,113,21,26,5,165,high,16,0,0
2021-08-23 16:30:00,120,29,37,6,192,heavy,16,0,0
2021-08-23 16:45:00,129,10,39,6,184,heavy,16,0,0
2021-08-23 17:00:00,119,29,40,10,198,heavy,17,0,0
2021-08-23 17:15:00,119,25,32,9,185,heavy,17,0,0
2021-08-23 17:30:00,123,10,30,7,170,heavy,17,0,0
2021-08-23 17:45:00,111,33,28,5,177,heavy,17,0,0
2021-08-23 18:00:00,110,12,47,8,177,heavy,18,0,0
2021-08-23 18:15:00,139,15,43,9,206,heavy,18,0,0
2021-08-23 18:30:00,132,29,25,7,193,heavy,18,0,0
2021-08-23 18:45:00,51,8,18,18,95,normal,18,0,0
2021-08-23 19:00:00,76,5,14,20,115,normal,19,0,0
2021-08-23 19:15:00,53,15,13,23,104,normal,19,0,0
2021-08-23 19:30:00,50,25,19,9,103,normal,19,0,0
2021-08-23 19:45:00,86,24,20,34,164,high,19,0,0
2021-08-23 20:00:00,67,23,14,13,117,normal,20,0,0
2021-08-23 20:15:00,54,9,15,7,85,low,20,0,0
2021-08-23 20:30:00,59,12,16,35,122,high,20,0,0
2021-08-23 20:45:00,109,25,15,5,154,normal,20,0,0
2021-08-23 21:00:00,73,18,10,35,136,high,21,0,0
2021-08-23 21:15:00,65,24,14,19,122,normal,21,0,0
2021-08-23 21:30:00,94,10,11,22,137,normal,21,0,0
2021-08-23 21:45:00,106,9,12,31,158,high,21,0,0
2021-08-23 22:00:00,18,3,0,11,32,low,22,0,0
2021-08-23 22:15:00,17,1,1,36,55,normal,22,0,0
2021-08-23 22:30:00,12,0,0,22,34,normal,22,0,0
2021-08-23 22:45:00,11,1,0,19,31,normal,22,0,0
2021-08-23 23:00:00,16,1,0,32,49,normal,23,0,0
2021-08-23 23:15:00,12,3,1,13,29,low,23,0,0
2021-08-23 23:30:00,14,4,1,27,46,normal,23,0,0
2021-08-23 23:45:00,11,3,1,37,52,normal,23,0,0
2021-08-24 00:00:00,17,2,0,18,37,low,0,1,0
2021-08-24 00:15:00,18,4,1,39,62,normal,0,1,0
2021-08-24 00:30:00,20,4,0,32,56,normal,0,1,0
2021-08-24 00:45:00,15,0,0,28,43,normal,0,1,0
2021-08-24 01:00:00,11,4,0,12,27,low,1,1,0
2021-08-24 01:15:00,19,5,1,35,60,normal,1,1,0
2021-08-24 01:30:00,15,0,1,26,42,normal,1,1,0
2021-08-24 01:45:00,11,4,0,31,46,normal,1,1,0
2021-08-24 02:00:00,19,2,1,33,55,normal,2,1,0
2021-08-24 02:15:00,12,4,1,29,46,normal,2,1,0
2021-08-24 02:30:00,15,5,1,16,37,low,2,1,0
2021-08-24 02:45:00,14,4,1,21,40,normal,2,1,0
2021-08-24 03:00:00,19,4,1,17,41,low,3,1,0
2021-08-24 03:15:00,10,2,1,12,25,low,3,1,0
2021-08-24 03:30:00,10,0,0,11,21,low,3,1,0
2021-08-24 03:45:00,20,4,1,33,58,normal,3,1,0
2021-08-24 04:00:00,10,1,0,12,23,low,4,1,0
2021-08-24 04:15:00,73,12,5,5,95,low,4,1,0
2021-08-24 04:30:00,95,15,4,19,133,normal,4,1,0
2021-08-24 04:45:00,81,19,3,13,116,normal,4,1,0
2021-08-24 05:00:00,119,25,10,9,163,normal,5,1,0
2021-08-24 05:15:00,80,10,4,15,109,low,5,1,0
2021-08-24 05:30:00,102,24,3,16,145,normal,5,1,0
2021-08-24 05:45:00,68,17,6,10,101,low,5,1,0
2021-08-24 06:00:00,109,40,38,0,187,heavy,6,1,0
2021-08-24 06:15:00,124,25,31,1,181,heavy,6,1,0
2021-08-24 06:30:00,126,22,21,1,170,heavy,6,1,0
2021-08-24 06:45:00,120,31,29,5,185,heavy,6,1,0
2021-08-24 07:00:00,101,20,47,5,173,heavy,7,1,0
2021-08-24 07:15:00,139,40,48,2,229,heavy,7,1,0
2021-08-24 07:30:00,116,23,23,4,166,normal,7,1,0
2021-08-24 07:45:00,101,14,24,0,139,normal,7,1,0
2021-08-24 08:00:00,137,40,21,5,203,heavy,8,1,0
2021-08-24 08:15:00,131,26,36,0,193,heavy,8,1,0
2021-08-24 08:30:00,114,27,45,4,190,heavy,8,1,0
2021-08-24 08:45:00,102,14,46,1,163,high,8,1,0
2021-08-24 09:00:00,116,24,32,5,177,heavy,9,1,0
2021-08-24 09:15:00,29,10,21,12,72,normal,9,1,0
2021-08-24 09:30:00,41,12,15,10,78,low,9,1,0
2021-08-24 09:45:00,41,9,7,27,84,normal,9,1,0
2021-08-24 10:00:00,90,25,26,10,151,high,10,1,0
2021-08-24 10:15:00,64,25,17,20,126,normal,10,1,0
2021-08-24 10:30:00,64,10,17,23,114,normal,10,1,0
2021-08-24 10:45:00,69,17,5,28,119,normal,10,1,0
2021-08-24 11:00:00,59,9,9,21,98,normal,11,1,0
2021-08-24 11:15:00,44,10,12,29,95,normal,11,1,0
2021-08-24 11:30:00,43,5,6,26,80,normal,11,1,0
2021-08-24 11:45:00,65,7,10,21,103,normal,11,1,0
2021-08-24 12:00:00,29,5,12,21,67,normal,12,1,0
2021-08-24 12:15:00,24,9,8,20,61,normal,12,1,0
2021-08-24 12:30:00,44,6,4,26,80,normal,12,1,0
2021-08-24 12:45:00,35,10,12,24,81,normal,12,1,0
2021-08-24 13:00:00,43,10,15,21,89,normal,13,1,0
2021-08-24 13:15:00,45,17,24,11,97,normal,13,1,0
2021-08-24 13:30:00,108,21,37,14,180,heavy,13,1,0
2021-08-24 13:45:00,53,19,33,9,114,high,13,1,0
2021-08-24 14:00:00,75,23,31,13,142,high,14,1,0
2021-08-24 14:15:00,70,18,5,19,112,normal,14,1,0
2021-08-24 14:30:00,52,25,15,19,111,normal,14,1,0
2021-08-24 14:45:00,9,18,24,9,60,normal,14,1,0
2021-08-24 15:00:00,47,21,9,18,95,low,15,1,0
2021-08-24 15:15:00,116,20,17,19,172,heavy,15,1,0
2021-08-24 15:30:00,65,14,6,9,94,low,15,1,0
2021-08-24 15:45:00,93,12,13,13,131,normal,15,1,0
2021-08-24 16:00:00,100,21,45,9,175,heavy,16,1,0
2021-08-24 16:15:00,121,24,31,6,182,heavy,16,1,0
2021-08-24 16:30:00,110,15,50,5,180,heavy,16,1,0
2021-08-24 16:45:00,103,17,28,5,153,high,16,1,0
2021-08-24 17:00:00,136,38,20,5,199,heavy,17,1,0
2021-08-24 17:15:00,119,22,32,9,182,heavy,17,1,0
2021-08-24 17:30:00,132,17,36,5,190,heavy,17,1,0
2021-08-24 17:45:00,147,10,41,5,203,heavy,17,1,0
2021-08-24 18:00:00,111,12,44,6,173,heavy,18,1,0
2021-08-24 18:15:00,102,27,32,5,166,high,18,1,0
2021-08-24 18:30:00,137,25,29,7,198,heavy,18,1,0
2021-08-24 18:45:00,71,17,15,31,134,high,18,1,0
2021-08-24 19:00:00,64,25,11,15,115,normal,19,1,0
2021-08-24 19:15:00,70,16,15,29,130,normal,19,1,0
2021-08-24 19:30:00,91,9,11,32,143,high,19,1,0
2021-08-24 19:45:00,95,6,11,35,147,high,19,1,0
2021-08-24 20:00:00,76,16,10,31,133,high,20,1,0
2021-08-24 20:15:00,87,17,18,7,129,normal,20,1,0
2021-08-24 20:30:00,63,22,12,29,126,normal,20,1,0
2021-08-24 20:45:00,56,17,20,8,101,normal,20,1,0
2021-08-24 21:00:00,102,18,19,29,168,heavy,21,1,0
2021-08-24 21:15:00,60,23,10,13,106,low,21,1,0
2021-08-24 21:30:00,88,6,18,25,137,normal,21,1,0
2021-08-24 21:45:00,104,15,10,32,161,high,21,1,0
2021-08-24 22:00:00,16,1,1,26,44,normal,22,1,0
2021-08-24 22:15:00,12,1,0,12,25,low,22,1,0
2021-08-24 22:30:00,16,1,0,29,46,normal,22,1,0
2021-08-24 22:45:00,13,5,0,31,49,normal,22,1,0
2021-08-24 23:00:00,20,1,1,27,49,normal,23,1,0
2021-08-24 23:15:00,18,0,0,29,47,normal,23,1,0
2021-08-24 23:30:00,16,3,1,26,46,normal,23,1,0
2021-08-24 23:45:00,18,0,0,21,39,normal,23,1,0
2021-08-25 00:00:00,11,5,0,24,40,normal,0,2,0
2021-08-25 00:15:00,13,1,0,10,24,low,0,2,0
2021-08-25 00:30:00,10,1,0,26,37,normal,0,2,0
2021-08-25 00:45:00,19,5,1,22,47,normal,0,2,0
2021-08-25 01:00:00,20,0,0,10,30,low,1,2,0
2021-08-25 01:15:00,16,4,1,39,60,normal,1,2,0
2021-08-25 01:30:00,19,1,1,11,32,low,1,2,0
2021-08-25 01:45:00,20,4,0,38,62,normal,1,2,0
2021-08-25 02:00:00,15,1,1,15,32,low,2,2,0
2021-08-25 02:15:00,10,0,0,33,43,normal,2,2,0
2021-08-25 02:30:00,20,5,0,24,49,normal,2,2,0
2021-08-25 02:45:00,12,2,1,35,50,normal,2,2,0
2021-08-25 03:00:00,10,4,1,37,52,normal,3,2,0
2021-08-25 03:15:00,15,4,0,38,57,normal,3,2,0
2021-08-25 03:30:00,19,0,1,39,59,normal,3,2,0
2021-08-25 03:45:00,16,4,0,35,55,normal,3,2,0
2021-08-25 04:00:00,20,3,1,35,59,normal,4,2,0
2021-08-25 04:15:00,118,1,0,4,123,normal,4,2,0
2021-08-25 04:30:00,89,20,4,17,130,normal,4,2,0
2021-08-25 04:45:00,120,18,6,13,157,normal,4,2,0
2021-08-25 05:00:00,85,7,3,18,113,normal,5,2,0
2021-08-25 05:15:00,99,8,2,14,123,normal,5,2,0
2021-08-25 05:30:00,59,25,2,7,93,low,5,2,0
2021-08-25 05:45:00,58,25,2,5,90,low,5,2,0
2021-08-25 06:00:00,113,40,36,4,193,heavy,6,2,0
2021-08-25 06:15:00,113,16,50,2,181,heavy,6,2,0
2021-08-25 06:30:00,121,27,50,4,202,heavy,6,2,0
2021-08-25 06:45:00,150,17,28,0,195,heavy,6,2,0
2021-08-25 07:00:00,136,29,23,0,188,heavy,7,2,0
2021-08-25 07:15:00,142,32,27,2,203,heavy,7,2,0
2021-08-25 07:30:00,106,32,42,2,182,heavy,7,2,0
2021-08-25 07:45:00,103,21,20,0,144,normal,7,2,0
2021-08-25 08:00:00,131,19,26,1,177,heavy,8,2,0
2021-08-25 08:15:00,133,23,21,3,180,heavy,8,2,0
2021-08-25 08:30:00,123,17,50,1,191,heavy,8,2,0
2021-08-25 08:45:00,124,21,35,2,182,heavy,8,2,0
2021-08-25 09:00:00,136,26,20,4,186,heavy,9,2,0
2021-08-25 09:15:00,92,10,39,19,160,high,9,2,0
2021-08-25 09:30:00,82,7,13,19,121,normal,9,2,0
2021-08-25 09:45:00,42,2,28,27,99,normal,9,2,0
2021-08-25 10:00:00,24,17,17,9,67,normal,10,2,0
2021-08-25 10:15:00,42,19,17,12,90,normal,10,2,0
2021-08-25 10:30:00,100,12,5,23,140,normal,10,2,0
2021-08-25 10:45:00,11,25,30,22,88,normal,10,2,0
2021-08-25 11:00:00,27,7,10,22,66,normal,11,2,0
2021-08-25 11:15:00,38,7,11,20,76,normal,11,2,0
2021-08-25 11:30:00,49,10,6,27,92,normal,11,2,0
2021-08-25 11:45:00,66,9,7,28,110,normal,11,2,0
2021-08-25 12:00:00,70,8,3,22,103,normal,12,2,0
2021-08-25 12:15:00,58,7,6,27,98,normal,12,2,0
2021-08-25 12:30:00,53,9,13,29,104,normal,12,2,0
2021-08-25 12:45:00,22,5,6,26,59,normal,12,2,0
2021-08-25 13:00:00,40,10,11,28,89,normal,13,2,0
2021-08-25 13:15:00,58,13,10,12,93,low,13,2,0
2021-08-25 13:30:00,60,25,24,17,126,normal,13,2,0
2021-08-25 13:45:00,25,11,24,17,77,normal,13,2,0
2021-08-25 14:00:00,22,28,11,18,79,low,14,2,0
2021-08-25 14:15:00,6,11,37,15,69,normal,14,2,0
2021-08-25 14:30:00,92,18,34,18,162,high,14,2,0
2021-08-25 14:45:00,97,17,38,20,172,heavy,14,2,0
2021-08-25 15:00:00,92,18,31,6,147,high,15,2,0
2021-08-25 15:15:00,74,12,17,16,119,normal,15,2,0
2021-08-25 15:30:00,67,22,7,5,101,low,15,2,0
2021-08-25 15:45:00,84,20,25,15,144,normal,15,2,0
2021-08-25 16:00:00,144,15,42,8,209,heavy,16,2,0
2021-08-25 16:15:00,120,11,47,7,185,heavy,16,2,0
2021-08-25 16:30:00,108,10,36,6,160,high,16,2,0
2021-08-25 16:45:00,141,13,50,6,210,heavy,16,2,0
2021-08-25 17:00:00,121,37,29,8,195,heavy,17,2,0
2021-08-25 17:15:00,142,40,22,6,210,heavy,17,2,0
2021-08-25 17:30:00,137,23,28,7,195,heavy,17,2,0
2021-08-25 17:45:00,117,10,27,8,162,high,17,2,0
2021-08-25 18:00:00,100,16,37,7,160,high,18,2,0
2021-08-25 18:15:00,148,11,42,8,209,heavy,18,2,0
2021-08-25 18:30:00,148,27,39,6,220,heavy,18,2,0
2021-08-25 18:45:00,65,18,20,21,124,normal,18,2,0
2021-08-25 19:00:00,75,9,14,6,104,low,19,2,0
2021-08-25 19:15:00,85,15,20,29,149,normal,19,2,0
2021-08-25 19:30:00,57,21,20,18,116,normal,19,2,0
2021-08-25 19:45:00,50,7,13,30,100,normal,19,2,0
2021-08-25 20:00:00,87,21,14,34,156,high,20,2,0
2021-08-25 20:15:00,64,24,11,6,105,low,20,2,0
2021-08-25 20:30:00,76,6,18,14,114,normal,20,2,0
2021-08-25 20:45:00,69,11,12,8,100,low,20,2,0
2021-08-25 21:00:00,76,9,17,14,116,normal,21,2,0
2021-08-25 21:15:00,94,8,15,5,122,normal,21,2,0
2021-08-25 21:30:00,104,10,16,33,163,high,21,2,0
2021-08-25 21:45:00,98,13,13,33,157,high,21,2,0
2021-08-25 22:00:00,13,5,0,18,36,low,22,2,0
2021-08-25 22:15:00,17,1,0,11,29,low,22,2,0
2021-08-25 22:30:00,18,2,1,34,55,normal,22,2,0
2021-08-25 22:45:00,11,1,0,35,47,normal,22,2,0
2021-08-25 23:00:00,17,4,0,11,32,low,23,2,0
2021-08-25 23:15:00,17,1,1,23,42,normal,23,2,0
2021-08-25 23:30:00,17,2,0,23,42,normal,23,2,0
2021-08-25 23:45:00,16,4,1,30,51,normal,23,2,0
2021-08-26 00:00:00,15,5,1,23,44,normal,0,3,0
2021-08-26 00:15:00,18,0,0,31,49,normal,0,3,0
2021-08-26 00:30:00,10,1,0,17,28,low,0,3,0
2021-08-26 00:45:00,13,2,0,32,47,normal,0,3,0
2021-08-26 01:00:00,16,1,0,38,55,normal,1,3,0
2021-08-26 01:15:00,11,4,0,32,47,normal,1,3,0
2021-08-26 01:30:00,12,2,0,26,40,normal,1,3,0
2021-08-26 01:45:00,14,2,1,14,31,low,1,3,0
2021-08-26 02:00:00,18,2,0,37,57,normal,2,3,0
2021-08-26 02:15:00,17,1,1,22,41,normal,2,3,0
2021-08-26 02:30:00,12,3,0,29,44,normal,2,3,0
2021-08-26 02:45:00,20,5,0,30,55,normal,2,3,0
2021-08-26 03:00:00,17,5,1,19,42,normal,3,3,0
2021-08-26 03:15:00,12,0,1,33,46,normal,3,3,0
2021-08-26 03:30:00,19,1,0,20,40,normal,3,3,0
2021-08-26 03:45:00,11,4,1,38,54,normal,3,3,0
2021-08-26 04:00:00,14,5,0,39,58,normal,4,3,0
2021-08-26 04:15:00,102,20,4,12,138,normal,4,3,0
2021-08-26 04:30:00,92,4,6,18,120,normal,4,3,0
2021-08-26 04:45:00,54,14,10,16,94,low,4,3,0
2021-08-26 05:00:00,55,15,1,10,81,low,5,3,0
2021-08-26 05:15:00,64,27,5,5,101,low,5,3,0
2021-08-26 05:30:00,52,13,5,15,85,low,5,3,0
2021-08-26 05:45:00,73,11,4,3,91,low,5,3,0
2021-08-26 06:00:00,106,27,45,5,183,heavy,6,3,0
2021-08-26 06:15:00,145,21,40,5,211,heavy,6,3,0
2021-08-26 06:30:00,133,19,28,5,185,heavy,6,3,0
2021-08-26 06:45:00,117,31,49,0,197,heavy,6,3,0
2021-08-26 07:00:00,146,17,34,0,197,heavy,7,3,0
2021-08-26 07:15:00,101,35,42,3,181,heavy,7,3,0
2021-08-26 07:30:00,103,28,32,1,164,high,7,3,0
2021-08-26 07:45:00,150,10,26,0,186,heavy,7,3,0
2021-08-26 08:00:00,135,23,48,0,206,heavy,8,3,0
2021-08-26 08:15:00,104,10,48,2,164,high,8,3,0
2021-08-26 08:30:00,144,39,50,1,234,heavy,8,3,0
2021-08-26 08:45:00,132,10,49,0,191,heavy,8,3,0
2021-08-26 09:00:00,142,19,31,1,193,heavy,9,3,0
2021-08-26 09:15:00,45,4,30,29,108,normal,9,3,0
2021-08-26 09:30:00,27,24,10,5,66,low,9,3,0
2021-08-26 09:45:00,85,3,14,16,118,normal,9,3,0
2021-08-26 10:00:00,84,11,27,26,148,high,10,3,0
2021-08-26 10:15:00,90,4,10,20,124,normal,10,3,0
2021-08-26 10:30:00,13,19,39,12,83,normal,10,3,0
2021-08-26 10:45:00,11,1,37,9,58,normal,10,3,0
2021-08-26 11:00:00,57,10,4,27,98,normal,11,3,0
2021-08-26 11:15:00,52,10,9,23,94,normal,11,3,0
2021-08-26 11:30:00,38,7,13,21,79,normal,11,3,0
2021-08-26 11:45:00,35,7,15,24,81,normal,11,3,0
2021-08-26 12:00:00,60,10,12,21,103,normal,12,3,0
2021-08-26 12:15:00,70,10,3,30,113,normal,12,3,0
2021-08-26 12:30:00,34,8,6,30,78,normal,12,3,0
2021-08-26 12:45:00,44,6,4,27,81,normal,12,3,0
2021-08-26 13:00:00,21,5,4,25,55,normal,13,3,0
2021-08-26 13:15:00,106,10,11,11,138,normal,13,3,0
2021-08-26 13:30:00,82,30,32,10,154,high,13,3,0
2021-08-26 13:45:00,57,12,9,17,95,low,13,3,0
2021-08-26 14:00:00,60,18,21,10,109,normal,14,3,0
2021-08-26 14:15:00,79,17,34,8,138,high,14,3,0
2021-08-26 14:30:00,78,29,22,13,142,normal,14,3,0
2021-08-26 14:45:00,69,14,32,18,133,high,14,3,0
2021-08-26 15:00:00,84,25,5,9,123,normal,15,3,0
2021-08-26 15:15:00,62,11,28,5,106,normal,15,3,0
2021-08-26 15:30:00,33,17,22,18,90,normal,15,3,0
2021-08-26 15:45:00,14,21,23,6,64,normal,15,3,0
2021-08-26 16:00:00,127,27,40,5,199,heavy,16,3,0
2021-08-26 16:15:00,136,10,27,7,180,heavy,16,3,0
2021-08-26 16:30:00,148,14,37,9,208,heavy,16,3,0
2021-08-26 16:45:00,122,16,28,6,172,heavy,16,3,0
2021-08-26 17:00:00,132,12,45,9,198,heavy,17,3,0
2021-08-26 17:15:00,136,29,29,10,204,heavy,17,3,0
2021-08-26 17:30:00,103,33,48,10,194,heavy,17,3,0
2021-08-26 17:45:00,132,37,23,10,202,heavy,17,3,0
2021-08-26 18:00:00,136,39,39,6,220,heavy,18,3,0
2021-08-26 18:15:00,120,24,36,5,185,heavy,18,3,0
2021-08-26 18:30:00,126,34,38,9,207,heavy,18,3,0
2021-08-26 18:45:00,80,22,14,18,134,normal,18,3,0
2021-08-26 19:00:00,99,9,15,29,152,normal,19,3,0
2021-08-26 19:15:00,81,21,19,7,128,normal,19,3,0
2021-08-26 19:30:00,87,9,16,26,138,normal,19,3,0
2021-08-26 19:45:00,80,17,13,30,140,normal,19,3,0
2021-08-26 20:00:00,91,18,18,9,136,normal,20,3,0
2021-08-26 20:15:00,90,19,15,13,137,normal,20,3,0
2021-08-26 20:30:00,107,19,10,23,159,normal,20,3,0
2021-08-26 20:45:00,98,11,14,27,150,normal,20,3,0
2021-08-26 21:00:00,98,18,20,22,158,normal,21,3,0
2021-08-26 21:15:00,102,5,12,17,136,normal,21,3,0
2021-08-26 21:30:00,62,13,16,28,119,normal,21,3,0
2021-08-26 21:45:00,101,15,12,35,163,high,21,3,0
2021-08-26 22:00:00,17,5,1,16,39,low,22,3,0
2021-08-26 22:15:00,10,4,1,37,52,normal,22,3,0
2021-08-26 22:30:00,16,4,0,35,55,normal,22,3,0
2021-08-26 22:45:00,17,2,0,17,36,low,22,3,0
2021-08-26 23:00:00,17,0,0,27,44,normal,23,3,0
2021-08-26 23:15:00,17,4,1,25,47,normal,23,3,0
2021-08-26 23:30:00,15,2,0,15,32,low,23,3,0
2021-08-26 23:45:00,20,0,1,12,33,low,23,3,0
2021-08-27 00:00:00,16,3,0,28,47,normal,0,4,0
2021-08-27 00:15:00,13,2,1,28,44,normal,0,4,0
2021-08-27 00:30:00,15,5,0,26,46,normal,0,4,0
2021-08-27 00:45:00,15,2,1,16,34,low,0,4,0
2021-08-27 01:00:00,12,3,0,26,41,normal,1,4,0
2021-08-27 01:15:00,15,5,0,27,47,normal,1,4,0
2021-08-27 01:30:00,20,2,0,17,39,low,1,4,0
2021-08-27 01:45:00,12,2,0,16,30,low,1,4,0
2021-08-27 02:00:00,19,1,0,38,58,normal,2,4,0
2021-08-27 02:15:00,16,1,1,32,50,normal,2,4,0
2021-08-27 02:30:00,12,0,0,11,23,low,2,4,0
2021-08-27 02:45:00,16,5,1,29,51,normal,2,4,0
2021-08-27 03:00:00,19,5,1,18,43,low,3,4,0
2021-08-27 03:15:00,11,0,0,15,26,low,3,4,0
2021-08-27 03:30:00,15,4,1,17,37,low,3,4,0
2021-08-27 03:45:00,20,1,0,23,44,normal,3,4,0
2021-08-27 04:00:00,10,4,0,36,50,normal,4,4,0
2021-08-27 04:15:00,39,14,0,15,68,low,4,4,0
2021-08-27 04:30:00,33,7,3,10,53,low,4,4,0
2021-08-27 04:45:00,77,8,7,15,107,low,4,4,0
2021-08-27 05:00:00,80,18,6,11,115,normal,5,4,0
2021-08-27 05:15:00,53,11,7,15,86,low,5,4,0
2021-08-27 05:30:00,73,17,6,13,109,low,5,4,0
2021-08-27 05:45:00,77,20,4,13,114,normal,5,4,0
2021-08-27 06:00:00,76,14,1,12,103,low,6,4,0
2021-08-27 06:15:00,58,14,0,15,87,low,6,4,0
2021-08-27 06:30:00,57,18,7,13,95,low,6,4,0
2021-08-27 06:45:00,80,16,0,10,106,low,6,4,0
2021-08-27 07:00:00,38,7,1,13,59,low,7,4,0
2021-08-27 07:15:00,53,20,6,12,91,low,7,4,0
2021-08-27 07:30:00,30,9,7,10,56,low,7,4,0
2021-08-27 07:45:00,50,19,4,10,83,low,7,4,0
2021-08-27 08:00:00,31,14,3,14,62,low,8,4,0
2021-08-27 08:15:00,28,18,5,10,61,low,8,4,0
2021-08-27 08:30:00,31,15,4,12,62,low,8,4,0
2021-08-27 08:45:00,52,19,0,10,81,low,8,4,0
2021-08-27 09:00:00,42,9,2,13,66,low,9,4,0
2021-08-27 09:15:00,151,55,27,2,235,heavy,9,4,0
2021-08-27 09:30:00,180,69,29,1,279,heavy,9,4,0
2021-08-27 09:45:00,149,41,23,3,216,heavy,9,4,0
2021-08-27 10:00:00,167,60,27,3,257,heavy,10,4,0
2021-08-27 10:15:00,134,45,22,3,204,heavy,10,4,0
2021-08-27 10:30:00,180,62,26,4,272,heavy,10,4,0
2021-08-27 10:45:00,156,54,25,3,238,heavy,10,4,0
2021-08-27 11:00:00,171,60,18,1,250,heavy,11,4,0
2021-08-27 11:15:00,174,53,10,3,240,heavy,11,4,0
2021-08-27 11:30:00,154,61,16,3,234,heavy,11,4,0
2021-08-27 11:45:00,161,53,11,1,226,heavy,11,4,0
2021-08-27 12:00:00,148,48,13,2,211,heavy,12,4,0
2021-08-27 12:15:00,136,60,27,2,225,heavy,12,4,0
2021-08-27 12:30:00,143,68,16,0,227,heavy,12,4,0
2021-08-27 12:45:00,152,51,22,2,227,heavy,12,4,0
2021-08-27 13:00:00,132,58,15,4,209,heavy,13,4,0
2021-08-27 13:15:00,155,58,15,4,232,heavy,13,4,0
2021-08-27 13:30:00,144,62,12,3,221,heavy,13,4,0
2021-08-27 13:45:00,161,51,20,1,233,heavy,13,4,0
2021-08-27 14:00:00,137,46,13,2,198,heavy,14,4,0
2021-08-27 14:15:00,149,61,16,1,227,heavy,14,4,0
2021-08-27 14:30:00,158,46,20,1,225,heavy,14,4,0
2021-08-27 14:45:00,134,65,22,0,221,heavy,14,4,0
2021-08-27 15:00:00,134,65,10,2,211,heavy,15,4,0
2021-08-27 15:15:00,73,24,4,0,101,low,15,4,0
2021-08-27 15:30:00,64,23,21,1,109,normal,15,4,0
2021-08-27 15:45:00,51,27,25,2,105,normal,15,4,0
2021-08-27 16:00:00,80,22,17,0,119,normal,16,4,0
2021-08-27 16:15:00,61,26,8,0,95,low,16,4,0
2021-08-27 16:30:00,75,24,8,0,107,low,16,4,0
2021-08-27 16:45:00,82,20,15,2,119,normal,16,4,0
2021-08-27 17:00:00,53,28,21,1,103,normal,17,4,0
2021-08-27 17:15:00,68,29,14,0,111,low,17,4,0
2021-08-27 17:30:00,63,28,22,0,113,normal,17,4,0
2021-08-27 17:45:00,76,30,20,1,127,normal,17,4,0
2021-08-27 18:00:00,66,23,10,0,99,low,18,4,0
2021-08-27 18:15:00,50,23,1,0,74,low,18,4,0
2021-08-27 18:30:00,60,29,22,2,113,normal,18,4,0
2021-08-27 18:45:00,75,26,11,0,112,normal,18,4,0
2021-08-27 19:00:00,81,22,18,2,123,normal,19,4,0
2021-08-27 19:15:00,33,6,0,4,43,low,19,4,0
2021-08-27 19:30:00,21,5,6,15,47,low,19,4,0
2021-08-27 19:45:00,22,7,1,2,32,low,19,4,0
2021-08-27 20:00:00,31,6,0,15,52,low,20,4,0
2021-08-27 20:15:00,41,8,3,2,54,low,20,4,0
2021-08-27 20:30:00,24,6,5,11,46,low,20,4,0
2021-08-27 20:45:00,45,6,6,10,67,low,20,4,0
2021-08-27 21:00:00,24,11,6,2,43,low,21,4,0
2021-08-27 21:15:00,47,6,2,12,67,low,21,4,0
2021-08-27 21:30:00,46,1,1,4,52,low,21,4,0
2021-08-27 21:45:00,26,3,2,3,34,low,21,4,0
2021-08-27 22:00:00,20,4,0,39,63,normal,22,4,0
2021-08-27 22:15:00,20,1,1,27,49,normal,22,4,0
2021-08-27 22:30:00,19,0,1,17,37,low,22,4,0
2021-08-27 22:45:00,11,3,1,19,34,normal,22,4,0
2021-08-27 23:00:00,17,5,1,31,54,normal,23,4,0
2021-08-27 23:15:00,19,4,0,12,35,low,23,4,0
2021-08-27 23:30:00,11,1,0,38,50,normal,23,4,0
2021-08-27 23:45:00,12,0,0,17,29,low,23,4,0
2021-08-28 00:00:00,18,0,0,27,45,normal,0,5,0
2021-08-28 00:15:00,19,4,0,14,37,low,0,5,0
2021-08-28 00:30:00,13,2,0,28,43,normal,0,5,0
2021-08-28 00:45:00,18,4,1,23,46,normal,0,5,0
2021-08-28 01:00:00,20,0,0,11,31,low,1,5,0
2021-08-28 01:15:00,11,4,1,22,38,normal,1,5,0
2021-08-28 01:30:00,15,2,0,18,35,low,1,5,0
2021-08-28 01:45:00,16,3,0,34,53,normal,1,5,0
2021-08-28 02:00:00,11,2,0,18,31,low,2,5,0
2021-08-28 02:15:00,17,4,1,38,60,normal,2,5,0
2021-08-28 02:30:00,20,4,1,28,53,normal,2,5,0
2021-08-28 02:45:00,19,0,1,37,57,normal,2,5,0
2021-08-28 03:00:00,10,2,1,34,47,normal,3,5,0
2021-08-28 03:15:00,19,0,0,17,36,low,3,5,0
2021-08-28 03:30:00,15,0,0,30,45,normal,3,5,0
2021-08-28 03:45:00,10,2,0,31,43,normal,3,5,0
2021-08-28 04:00:00,18,3,0,17,38,low,4,5,0
2021-08-28 04:15:00,97,22,4,18,141,normal,4,5,0
2021-08-28 04:30:00,111,12,9,17,149,normal,4,5,0
2021-08-28 04:45:00,108,10,5,17,140,normal,4,5,0
2021-08-28 05:00:00,74,24,10,20,128,normal,5,5,0
2021-08-28 05:15:00,114,4,8,20,146,normal,5,5,0
2021-08-28 05:30:00,91,16,5,11,123,normal,5,5,0
2021-08-28 05:45:00,66,3,9,19,97,normal,5,5,0
2021-08-28 06:00:00,104,32,23,5,164,normal,6,5,0
2021-08-28 06:15:00,128,18,31,3,180,heavy,6,5,0
2021-08-28 06:30:00,127,24,27,0,178,heavy,6,5,0
2021-08-28 06:45:00,130,31,22,0,183,heavy,6,5,0
2021-08-28 07:00:00,108,13,38,1,160,high,7,5,0
2021-08-28 07:15:00,116,22,37,2,177,heavy,7,5,0
2021-08-28 07:30:00,143,28,27,4,202,heavy,7,5,0
2021-08-28 07:45:00,118,32,21,5,176,heavy,7,5,0
2021-08-28 08:00:00,121,35,32,0,188,heavy,8,5,0
2021-08-28 08:15:00,109,28,39,2,178,heavy,8,5,0
2021-08-28 08:30:00,135,11,23,5,174,heavy,8,5,0
2021-08-28 08:45:00,100,30,29,2,161,high,8,5,0
2021-08-28 09:00:00,138,32,26,4,200,heavy,9,5,0
2021-08-28 09:15:00,29,9,21,23,82,normal,9,5,0
2021-08-28 09:30:00,36,17,7,30,90,normal,9,5,0
2021-08-28 09:45:00,42,9,37,28,116,high,9,5,0
2021-08-28 10:00:00,80,6,12,6,104,low,10,5,0
2021-08-28 10:15:00,37,21,28,6,92,normal,10,5,0
2021-08-28 10:30:00,44,17,27,30,118,high,10,5,0
2021-08-28 10:45:00,25,12,13,5,55,low,10,5,0
2021-08-28 11:00:00,36,9,9,30,84,normal,11,5,0
2021-08-28 11:15:00,63,7,10,29,109,normal,11,5,0
2021-08-28 11:30:00,20,5,13,22,60,normal,11,5,0
2021-08-28 11:45:00,53,8,6,23,90,normal,11,5,0
2021-08-28 12:00:00,41,7,5,26,79,normal,12,5,0
2021-08-28 12:15:00,36,9,13,29,87,normal,12,5,0
2021-08-28 12:30:00,65,10,8,22,105,normal,12,5,0
2021-08-28 12:45:00,55,6,5,27,93,normal,12,5,0
2021-08-28 13:00:00,63,8,15,30,116,normal,13,5,0
2021-08-28 13:15:00,19,26,32,18,95,normal,13,5,0
2021-08-28 13:30:00,84,11,11,9,115,normal,13,5,0
2021-08-28 13:45:00,110,23,34,9,176,heavy,13,5,0
2021-08-28 14:00:00,46,20,18,5,89,normal,14,5,0
2021-08-28 14:15:00,67,12,10,20,109,normal,14,5,0
2021-08-28 14:30:00,42,25,20,19,106,normal,14,5,0
2021-08-28 14:45:00,87,17,18,6,128,normal,14,5,0
2021-08-28 15:00:00,45,24,31,11,111,normal,15,5,0
2021-08-28 15:15:00,80,26,35,6,147,high,15,5,0
2021-08-28 15:30:00,83,18,6,15,122,normal,15,5,0
2021-08-28 15:45:00,68,19,15,11,113,normal,15,5,0
2021-08-28 16:00:00,101,37,48,9,195,heavy,16,5,0
2021-08-28 16:15:00,149,32,29,10,220,heavy,16,5,0
2021-08-28 16:30:00,136,21,33,9,199,heavy,16,5,0
2021-08-28 16:45:00,105,20,23,7,155,normal,16,5,0
2021-08-28 17:00:00,125,12,20,8,165,normal,17,5,0
2021-08-28 17:15:00,125,14,26,5,170,heavy,17,5,0
2021-08-28 17:30:00,118,28,23,8,177,heavy,17,5,0
2021-08-28 17:45:00,114,32,45,6,197,heavy,17,5,0
2021-08-28 18:00:00,123,37,46,8,214,heavy,18,5,0
2021-08-28 18:15:00,115,23,22,7,167,normal,18,5,0
2021-08-28 18:30:00,111,25,35,10,181,heavy,18,5,0
2021-08-28 18:45:00,66,8,11,9,94,low,18,5,0
2021-08-28 19:00:00,103,12,17,23,155,normal,19,5,0
2021-08-28 19:15:00,94,14,14,24,146,normal,19,5,0
2021-08-28 19:30:00,105,23,15,18,161,normal,19,5,0
2021-08-28 19:45:00,53,22,14,35,124,high,19,5,0
2021-08-28 20:00:00,74,10,12,32,128,high,20,5,0
2021-08-28 20:15:00,71,24,15,26,136,normal,20,5,0
2021-08-28 20:30:00,61,21,15,32,129,high,20,5,0
2021-08-28 20:45:00,101,25,18,8,152,normal,20,5,0
2021-08-28 21:00:00,104,22,10,14,150,normal,21,5,0
2021-08-28 21:15:00,79,20,15,18,132,normal,21,5,0
2021-08-28 21:30:00,70,20,11,14,115,normal,21,5,0
2021-08-28 21:45:00,74,16,14,34,138,high,21,5,0
2021-08-28 22:00:00,20,5,0,21,46,normal,22,5,0
2021-08-28 22:15:00,16,0,0,36,52,normal,22,5,0
2021-08-28 22:30:00,14,3,0,20,37,normal,22,5,0
2021-08-28 22:45:00,14,1,1,30,46,normal,22,5,0
2021-08-28 23:00:00,17,0,1,12,30,low,23,5,0
2021-08-28 23:15:00,14,0,0,14,28,low,23,5,0
2021-08-28 23:30:00,18,5,0,40,63,normal,23,5,0
2021-08-28 23:45:00,17,2,0,18,37,low,23,5,0
2021-08-29 00:00:00,14,1,1,35,51,normal,0,6,1
2021-08-29 00:15:00,14,2,1,26,43,normal,0,6,1
2021-08-29 00:30:00,16,0,1,37,54,normal,0,6,1
2021-08-29 00:45:00,14,4,1,32,51,normal,0,6,1
2021-08-29 01:00:00,19,5,0,12,36,low,1,6,1
2021-08-29 01:15:00,11,0,1,31,43,normal,1,6,1
2021-08-29 01:30:00,12,0,0,32,44,normal,1,6,1
2021-08-29 01:45:00,12,3,0,32,47,normal,1,6,1
2021-08-29 02:00:00,18,4,1,31,54,normal,2,6,1
2021-08-29 02:15:00,17,4,1,20,42,normal,2,6,1
2021-08-29 02:30:00,17,0,0,22,39,normal,2,6,1
2021-08-29 02:45:00,19,2,1,12,34,low,2,6,1
2021-08-29 03:00:00,18,2,1,19,40,normal,3,6,1
2021-08-29 03:15:00,19,5,0,26,50,normal,3,6,1
2021-08-29 03:30:00,19,5,1,35,60,normal,3,6,1
2021-08-29 03:45:00,18,0,0,20,38,normal,3,6,1
2021-08-29 04:00:00,16,0,0,30,46,normal,4,6,1
2021-08-29 04:15:00,114,30,9,7,160,normal,4,6,1
2021-08-29 04:30:00,102,17,2,14,135,normal,4,6,1
2021-08-29 04:45:00,55,4,7,13,79,low,4,6,1
2021-08-29 05:00:00,82,2,4,14,102,low,5,6,1
2021-08-29 05:15:00,66,16,9,19,110,normal,5,6,1
2021-08-29 05:30:00,86,5,1,13,105,low,5,6,1
2021-08-29 05:45:00,108,24,2,19,153,normal,5,6,1
2021-08-29 06:00:00,112,30,26,0,168,heavy,6,6,1
2021-08-29 06:15:00,147,31,46,0,224,heavy,6,6,1
2021-08-29 06:30:00,116,20,40,2,178,heavy,6,6,1
2021-08-29 06:45:00,138,13,21,5,177,heavy,6,6,1
2021-08-29 07:00:00,132,25,40,2,199,heavy,7,6,1
2021-08-29 07:15:00,124,14,31,4,173,heavy,7,6,1
2021-08-29 07:30:00,106,27,25,1,159,normal,7,6,1
2021-08-29 07:45:00,104,24,29,5,162,high,7,6,1
2021-08-29 08:00:00,140,31,21,4,196,heavy,8,6,1
2021-08-29 08:15:00,121,35,37,3,196,heavy,8,6,1
2021-08-29 08:30:00,135,23,37,5,200,heavy,8,6,1
2021-08-29 08:45:00,149,20,30,5,204,heavy,8,6,1
2021-08-29 09:00:00,117,14,39,0,170,heavy,9,6,1
2021-08-29 09:15:00,39,8,23,13,83,normal,9,6,1
2021-08-29 09:30:00,40,14,18,21,93,normal,9,6,1
2021-08-29 09:45:00,49,1,35,18,103,normal,9,6,1
2021-08-29 10:00:00,38,12,35,25,110,normal,10,6,1
2021-08-29 10:15:00,26,15,25,6,72,normal,10,6,1
2021-08-29 10:30:00,93,14,10,25,142,normal,10,6,1
2021-08-29 10:45:00,54,24,37,20,135,high,10,6,1
2021-08-29 11:00:00,32,6,10,23,71,normal,11,6,1
2021-08-29 11:15:00,43,7,12,23,85,normal,11,6,1
2021-08-29 11:30:00,23,6,15,20,64,normal,11,6,1
2021-08-29 11:45:00,26,5,8,25,64,normal,11,6,1
2021-08-29 12:00:00,55,7,8,27,97,normal,12,6,1
2021-08-29 12:15:00,70,10,8,25,113,normal,12,6,1
2021-08-29 12:30:00,66,10,3,29,108,normal,12,6,1
2021-08-29 12:45:00,66,7,15,26,114,normal,12,6,1
2021-08-29 13:00:00,46,6,7,21,80,normal,13,6,1
2021-08-29 13:15:00,47,26,6,20,99,normal,13,6,1
2021-08-29 13:30:00,75,20,7,11,113,normal,13,6,1
2021-08-29 13:45:00,76,29,15,19,139,normal,13,6,1
2021-08-29 14:00:00,56,14,38,12,120,high,14,6,1
2021-08-29 14:15:00,19,26,36,17,98,normal,14,6,1
2021-08-29 14:30:00,29,18,10,9,66,low,14,6,1
2021-08-29 14:45:00,15,12,18,15,60,normal,14,6,1
2021-08-29 15:00:00,53,27,27,17,124,high,15,6,1
2021-08-29 15:15:00,95,22,28,9,154,high,15,6,1
2021-08-29 15:30:00,27,27,32,10,96,normal,15,6,1
2021-08-29 15:45:00,68,28,31,15,142,high,15,6,1
2021-08-29 16:00:00,120,14,25,8,167,normal,16,6,1
2021-08-29 16:15:00,144,28,24,8,204,heavy,16,6,1
2021-08-29 16:30:00,112,31,43,8,194,heavy,16,6,1
2021-08-29 16:45:00,149,28,20,10,207,heavy,16,6,1
2021-08-29 17:00:00,131,29,34,8,202,heavy,17,6,1
2021-08-29 17:15:00,104,31,41,9,185,heavy,17,6,1
2021-08-29 17:30:00,141,30,27,7,205,heavy,17,6,1
2021-08-29 17:45:00,117,10,47,9,183,heavy,17,6,1
2021-08-29 18:00:00,112,13,37,6,168,heavy,18,6,1
2021-08-29 18:15:00,127,40,39,8,214,heavy,18,6,1
2021-08-29 18:30:00,131,15,31,6,183,heavy,18,6,1
2021-08-29 18:45:00,66,8,10,11,95,low,18,6,1
2021-08-29 19:00:00,61,23,18,34,136,high,19,6,1
2021-08-29 19:15:00,55,25,13,26,119,normal,19,6,1
2021-08-29 19:30:00,85,23,20,6,134,normal,19,6,1
2021-08-29 19:45:00,75,20,19,19,133,normal,19,6,1
2021-08-29 20:00:00,58,17,20,22,117,normal,20,6,1
2021-08-29 20:15:00,60,23,11,26,120,normal,20,6,1
2021-08-29 20:30:00,80,21,11,7,119,normal,20,6,1
2021-08-29 20:45:00,74,9,14,35,132,high,20,6,1
2021-08-29 21:00:00,57,14,11,16,98,low,21,6,1
2021-08-29 21:15:00,73,9,13,5,100,low,21,6,1
2021-08-29 21:30:00,80,25,19,26,150,normal,21,6,1
2021-08-29 21:45:00,82,13,12,21,128,normal,21,6,1
2021-08-29 22:00:00,15,4,0,27,46,normal,22,6,1
2021-08-29 22:15:00,20,2,0,29,51,normal,22,6,1
2021-08-29 22:30:00,12,2,0,39,53,normal,22,6,1
2021-08-29 22:45:00,10,4,1,13,28,low,22,6,1
2021-08-29 23:00:00,16,0,1,29,46,normal,23,6,1
2021-08-29 23:15:00,18,0,0,34,52,normal,23,6,1
2021-08-29 23:30:00,11,5,1,19,36,normal,23,6,1
2021-08-29 23:45:00,16,1,0,12,29,low,23,6,1
2021-08-30 00:00:00,13,3,1,12,29,low,0,0,0
2021-08-30 00:15:00,19,2,0,22,43,normal,0,0,0
2021-08-30 00:30:00,13,3,0,39,55,normal,0,0,0
2021-08-30 00:45:00,12,0,0,24,36,normal,0,0,0
2021-08-30 01:00:00,10,3,1,12,26,low,1,0,0
2021-08-30 01:15:00,11,4,0,38,53,normal,1,0,0
2021-08-30 01:30:00,18,4,0,31,53,normal,1,0,0
2021-08-30 01:45:00,19,1,0,34,54,normal,1,0,0
2021-08-30 02:00:00,18,1,0,27,46,normal,2,0,0
2021-08-30 02:15:00,13,0,0,26,39,normal,2,0,0
2021-08-30 02:30:00,12,2,0,35,49,normal,2,0,0
2021-08-30 02:45:00,15,4,0,12,31,low,2,0,0
2021-08-30 03:00:00,10,5,0,33,48,normal,3,0,0
2021-08-30 03:15:00,14,0,0,15,29,low,3,0,0
2021-08-30 03:30:00,16,0,0,16,32,low,3,0,0
2021-08-30 03:45:00,15,3,1,26,45,normal,3,0,0
2021-08-30 04:00:00,20,4,0,34,58,normal,4,0,0
2021-08-30 04:15:00,82,20,10,11,123,normal,4,0,0
2021-08-30 04:30:00,99,7,3,6,115,normal,4,0,0
2021-08-30 04:45:00,74,29,9,4,116,normal,4,0,0
2021-08-30 05:00:00,94,1,1,14,110,low,5,0,0
2021-08-30 05:15:00,63,12,10,17,102,low,5,0,0
2021-08-30 05:30:00,101,4,3,12,120,normal,5,0,0
2021-08-30 05:45:00,106,9,3,10,128,normal,5,0,0
2021-08-30 06:00:00,112,15,24,1,152,normal,6,0,0
2021-08-30 06:15:00,148,26,25,0,199,heavy,6,0,0
2021-08-30 06:30:00,115,20,31,3,169,heavy,6,0,0
2021-08-30 06:45:00,125,11,24,0,160,normal,6,0,0
2021-08-30 07:00:00,140,38,38,0,216,heavy,7,0,0
2021-08-30 07:15:00,150,17,35,5,207,heavy,7,0,0
2021-08-30 07:30:00,149,11,42,2,204,heavy,7,0,0
2021-08-30 07:45:00,150,22,38,3,213,heavy,7,0,0
2021-08-30 08:00:00,147,32,25,4,208,heavy,8,0,0
2021-08-30 08:15:00,138,39,45,4,226,heavy,8,0,0
2021-08-30 08:30:00,149,16,49,1,215,heavy,8,0,0
2021-08-30 08:45:00,139,10,50,2,201,heavy,8,0,0
2021-08-30 09:00:00,109,25,49,2,185,heavy,9,0,0
2021-08-30 09:15:00,84,24,12,28,148,normal,9,0,0
2021-08-30 09:30:00,38,8,6,5,57,low,9,0,0
2021-08-30 09:45:00,45,16,6,21,88,normal,9,0,0
2021-08-30 10:00:00,57,4,36,14,111,normal,10,0,0
2021-08-30 10:15:00,84,12,6,28,130,normal,10,0,0
2021-08-30 10:30:00,55,25,33,21,134,high,10,0,0
2021-08-30 10:45:00,14,15,5,21,55,normal,10,0,0
2021-08-30 11:00:00,26,8,11,20,65,normal,11,0,0
2021-08-30 11:15:00,60,10,9,27,106,normal,11,0,0
2021-08-30 11:30:00,34,6,7,25,72,normal,11,0,0
2021-08-30 11:45:00,22,9,8,26,65,normal,11,0,0
2021-08-30 12:00:00,59,10,11,30,110,normal,12,0,0
2021-08-30 12:15:00,48,6,14,28,96,normal,12,0,0
2021-08-30 12:30:00,46,9,11,23,89,normal,12,0,0
2021-08-30 12:45:00,37,9,8,20,74,normal,12,0,0
2021-08-30 13:00:00,67,9,11,21,108,normal,13,0,0
2021-08-30 13:15:00,32,19,39,9,99,normal,13,0,0
2021-08-30 13:30:00,63,12,22,5,102,normal,13,0,0
2021-08-30 13:45:00,32,29,25,11,97,normal,13,0,0
2021-08-30 14:00:00,83,22,40,20,165,high,14,0,0
2021-08-30 14:15:00,40,14,31,19,104,normal,14,0,0
2021-08-30 14:30:00,101,22,39,19,181,heavy,14,0,0
2021-08-30 14:45:00,62,29,31,11,133,high,14,0,0
2021-08-30 15:00:00,20,19,25,8,72,normal,15,0,0
2021-08-30 15:15:00,42,22,5,9,78,low,15,0,0
2021-08-30 15:30:00,37,17,12,16,82,low,15,0,0
2021-08-30 15:45:00,95,12,20,15,142,normal,15,0,0
2021-08-30 16:00:00,137,14,41,10,202,heavy,16,0,0
2021-08-30 16:15:00,122,21,20,10,173,heavy,16,0,0
2021-08-30 16:30:00,104,19,39,9,171,heavy,16,0,0
2021-08-30 16:45:00,147,21,40,9,217,heavy,16,0,0
2021-08-30 17:00:00,105,38,34,7,184,heavy,17,0,0
2021-08-30 17:15:00,124,23,46,5,198,heavy,17,0,0
2021-08-30 17:30:00,135,18,20,5,178,heavy,17,0,0
2021-08-30 17:45:00,107,35,23,8,173,heavy,17,0,0
2021-08-30 18:00:00,109,21,24,10,164,normal,18,0,0
2021-08-30 18:15:00,136,32,26,8,202,heavy,18,0,0
2021-08-30 18:30:00,134,23,49,8,214,heavy,18,0,0
2021-08-30 18:45:00,90,20,11,25,146,normal,18,0,0
2021-08-30 19:00:00,104,5,16,16,141,normal,19,0,0
2021-08-30 19:15:00,60,21,13,6,100,low,19,0,0
2021-08-30 19:30:00,104,22,11,13,150,normal,19,0,0
2021-08-30 19:45:00,54,23,10,25,112,normal,19,0,0
2021-08-30 20:00:00,68,6,15,34,123,high,20,0,0
2021-08-30 20:15:00,88,13,19,19,139,normal,20,0,0
2021-08-30 20:30:00,64,22,16,16,118,normal,20,0,0
2021-08-30 20:45:00,58,24,14,24,120,normal,20,0,0
2021-08-30 21:00:00,67,19,12,9,107,low,21,0,0
2021-08-30 21:15:00,73,20,18,7,118,normal,21,0,0
2021-08-30 21:30:00,109,25,16,20,170,heavy,21,0,0
2021-08-30 21:45:00,63,15,11,23,112,normal,21,0,0
2021-08-30 22:00:00,19,4,1,26,50,normal,22,0,0
2021-08-30 22:15:00,15,1,0,34,50,normal,22,0,0
2021-08-30 22:30:00,15,5,1,14,35,low,22,0,0
2021-08-30 22:45:00,19,3,1,33,56,normal,22,0,0
2021-08-30 23:00:00,18,4,0,11,33,low,23,0,0
2021-08-30 23:15:00,14,1,0,27,42,normal,23,0,0
2021-08-30 23:30:00,19,0,0,37,56,normal,23,0,0
2021-08-30 23:45:00,19,0,0,29,48,normal,23,0,0
2021-08-31 00:00:00,18,1,0,30,49,normal,0,1,0
2021-08-31 00:15:00,19,3,0,18,40,low,0,1,0
2021-08-31 00:30:00,15,2,1,34,52,normal,0,1,0
2021-08-31 00:45:00,17,0,1,14,32,low,0,1,0
2021-08-31 01:00:00,12,0,0,33,45,normal,1,1,0
2021-08-31 01:15:00,20,0,1,20,41,normal,1,1,0
2021-08-31 01:30:00,10,2,0,18,30,low,1,1,0
2021-08-31 01:45:00,13,3,0,31,47,normal,1,1,0
2021-08-31 02:00:00,10,0,1,38,49,normal,2,1,0
2021-08-31 02:15:00,19,1,1,28,49,normal,2,1,0
2021-08-31 02:30:00,19,4,0,16,39,low,2,1,0
2021-08-31 02:45:00,16,1,0,15,32,low,2,1,0
2021-08-31 03:00:00,17,1,0,34,52,normal,3,1,0
2021-08-31 03:15:00,19,1,0,21,41,normal,3,1,0
2021-08-31 03:30:00,10,1,0,39,50,normal,3,1,0
2021-08-31 03:45:00,16,4,0,15,35,low,3,1,0
2021-08-31 04:00:00,13,0,0,16,29,low,4,1,0
2021-08-31 04:15:00,98,5,1,17,121,normal,4,1,0
2021-08-31 04:30:00,65,10,3,8,86,low,4,1,0
2021-08-31 04:45:00,98,17,0,20,135,normal,4,1,0
2021-08-31 05:00:00,60,20,5,6,91,low,5,1,0
2021-08-31 05:15:00,110,18,10,11,149,normal,5,1,0
2021-08-31 05:30:00,70,13,4,13,100,low,5,1,0
2021-08-31 05:45:00,96,12,7,17,132,normal,5,1,0
2021-08-31 06:00:00,129,31,36,1,197,heavy,6,1,0
2021-08-31 06:15:00,146,28,47,3,224,heavy,6,1,0
2021-08-31 06:30:00,137,23,27,0,187,heavy,6,1,0
2021-08-31 06:45:00,131,28,24,0,183,heavy,6,1,0
2021-08-31 07:00:00,134,10,44,0,188,heavy,7,1,0
2021-08-31 07:15:00,109,25,24,0,158,normal,7,1,0
2021-08-31 07:30:00,108,35,22,3,168,heavy,7,1,0
2021-08-31 07:45:00,146,14,37,2,199,heavy,7,1,0
2021-08-31 08:00:00,147,21,41,5,214,heavy,8,1,0
2021-08-31 08:15:00,110,34,35,0,179,heavy,8,1,0
2021-08-31 08:30:00,110,40,50,2,202,heavy,8,1,0
2021-08-31 08:45:00,123,12,22,3,160,normal,8,1,0
2021-08-31 09:00:00,145,25,20,5,195,heavy,9,1,0
2021-08-31 09:15:00,82,15,16,29,142,normal,9,1,0
2021-08-31 09:30:00,62,2,7,22,93,normal,9,1,0
2021-08-31 09:45:00,92,8,11,21,132,normal,9,1,0
2021-08-31 10:00:00,35,22,22,18,97,normal,10,1,0
2021-08-31 10:15:00,66,25,13,13,117,normal,10,1,0
2021-08-31 10:30:00,50,2,25,12,89,normal,10,1,0
2021-08-31 10:45:00,50,22,24,7,103,normal,10,1,0
2021-08-31 11:00:00,50,8,5,24,87,normal,11,1,0
2021-08-31 11:15:00,55,5,5,21,86,normal,11,1,0
2021-08-31 11:30:00,51,10,14,24,99,normal,11,1,0
2021-08-31 11:45:00,34,8,14,21,77,normal,11,1,0
2021-08-31 12:00:00,25,7,5,20,57,normal,12,1,0
2021-08-31 12:15:00,59,7,9,21,96,normal,12,1,0
2021-08-31 12:30:00,38,10,9,24,81,normal,12,1,0
2021-08-31 12:45:00,70,10,9,23,112,normal,12,1,0
2021-08-31 13:00:00,63,8,13,22,106,normal,13,1,0
2021-08-31 13:15:00,6,24,12,13,55,low,13,1,0
2021-08-31 13:30:00,108,17,16,16,157,normal,13,1,0
2021-08-31 13:45:00,41,20,32,12,105,normal,13,1,0
2021-08-31 14:00:00,54,10,20,9,93,normal,14,1,0
2021-08-31 14:15:00,60,19,14,7,100,low,14,1,0
2021-08-31 14:30:00,102,11,9,11,133,normal,14,1,0
2021-08-31 14:45:00,50,24,30,5,109,normal,14,1,0
2021-08-31 15:00:00,25,24,19,10,78,normal,15,1,0
2021-08-31 15:15:00,90,25,18,20,153,normal,15,1,0
2021-08-31 15:30:00,86,13,27,11,137,high,15,1,0
2021-08-31 15:45:00,44,19,17,9,89,normal,15,1,0
2021-08-31 16:00:00,126,24,35,8,193,heavy,16,1,0
2021-08-31 16:15:00,146,26,42,9,223,normal,16,1,0
2021-08-31 16:30:00,117,28,33,10,188,heavy,16,1,0
2021-08-31 16:45:00,144,36,49,10,239,heavy,16,1,0
2021-08-31 17:00:00,137,19,23,9,188,heavy,17,1,0
2021-08-31 17:15:00,118,19,48,5,190,heavy,17,1,0
2021-08-31 17:30:00,119,27,28,8,182,heavy,17,1,0
2021-08-31 17:45:00,149,26,43,5,223,normal,17,1,0
2021-08-31 18:00:00,117,34,36,10,197,heavy,18,1,0
2021-08-31 18:15:00,124,30,44,10,208,heavy,18,1,0
2021-08-31 18:30:00,141,36,48,5,230,heavy,18,1,0
2021-08-31 18:45:00,78,6,11,28,123,normal,18,1,0
2021-08-31 19:00:00,102,23,16,24,165,normal,19,1,0
2021-08-31 19:15:00,104,18,18,23,163,normal,19,1,0
2021-08-31 19:30:00,95,9,19,7,130,normal,19,1,0
2021-08-31 19:45:00,105,13,12,20,150,normal,19,1,0
2021-08-31 20:00:00,100,18,16,34,168,heavy,20,1,0
2021-08-31 20:15:00,80,14,20,15,129,normal,20,1,0
2021-08-31 20:30:00,86,8,19,7,120,normal,20,1,0
2021-08-31 20:45:00,108,20,14,15,157,normal,20,1,0
2021-08-31 21:00:00,69,13,13,8,103,low,21,1,0
2021-08-31 21:15:00,64,14,10,6,94,low,21,1,0
2021-08-31 21:30:00,71,14,17,10,112,normal,21,1,0
2021-08-31 21:45:00,61,9,18,24,112,normal,21,1,0
2021-08-31 22:00:00,11,4,0,31,46,normal,22,1,0
2021-08-31 22:15:00,17,5,0,14,36,low,22,1,0
2021-08-31 22:30:00,15,5,0,18,38,low,22,1,0
2021-08-31 22:45:00,14,2,0,40,56,normal,22,1,0
2021-08-31 23:00:00,12,2,1,28,43,normal,23,1,0
2021-08-31 23:15:00,18,0,1,40,59,normal,23,1,0
2021-08-31 23:30:00,14,5,0,13,32,low,23,1,0
2021-08-31 23:45:00,18,1,0,26,45,normal,23,1,0
2021-09-01 00:00:00,14,0,0,34,48,normal,0,2,0
2021-09-01 00:15:00,17,5,0,23,45,normal,0,2,0
2021-09-01 00:30:00,19,1,1,18,39,low,0,2,0
2021-09-01 00:45:00,15,5,1,12,33,low,0,2,0
2021-09-01 01:00:00,13,2,1,26,42,normal,1,2,0
2021-09-01 01:15:00,15,3,0,32,50,normal,1,2,0
2021-09-01 01:30:00,15,0,1,13,29,low,1,2,0
2021-09-01 01:45:00,18,5,1,12,36,low,1,2,0
2021-09-01 02:00:00,17,1,0,29,47,normal,2,2,0
2021-09-01 02:15:00,10,4,0,19,33,normal,2,2,0
2021-09-01 02:30:00,15,0,0,18,33,low,2,2,0
2021-09-01 02:45:00,11,0,0,35,46,normal,2,2,0
2021-09-01 03:00:00,20,5,1,34,60,normal,3,2,0
2021-09-01 03:15:00,15,5,1,32,53,normal,3,2,0
2021-09-01 03:30:00,16,4,1,37,58,normal,3,2,0
2021-09-01 03:45:00,14,1,0,12,27,low,3,2,0
2021-09-01 04:00:00,16,4,0,18,38,low,4,2,0
2021-09-01 04:15:00,56,21,3,0,80,low,4,2,0
2021-09-01 04:30:00,78,11,10,18,117,normal,4,2,0
2021-09-01 04:45:00,82,29,0,20,131,normal,4,2,0
2021-09-01 05:00:00,102,15,2,7,126,normal,5,2,0
2021-09-01 05:15:00,69,14,6,18,107,low,5,2,0
2021-09-01 05:30:00,87,24,6,19,136,normal,5,2,0
2021-09-01 05:45:00,84,16,10,5,115,normal,5,2,0
2021-09-01 06:00:00,109,38,34,5,186,heavy,6,2,0
2021-09-01 06:15:00,147,38,23,3,211,heavy,6,2,0
2021-09-01 06:30:00,135,19,48,5,207,heavy,6,2,0
2021-09-01 06:45:00,101,23,41,5,170,heavy,6,2,0
2021-09-01 07:00:00,138,21,28,1,188,heavy,7,2,0
2021-09-01 07:15:00,136,20,32,1,189,heavy,7,2,0
2021-09-01 07:30:00,123,19,25,5,172,heavy,7,2,0
2021-09-01 07:45:00,108,30,46,5,189,heavy,7,2,0
2021-09-01 08:00:00,128,15,43,5,191,heavy,8,2,0
2021-09-01 08:15:00,129,37,41,1,208,heavy,8,2,0
2021-09-01 08:30:00,127,18,28,3,176,heavy,8,2,0
2021-09-01 08:45:00,142,37,46,3,228,heavy,8,2,0
2021-09-01 09:00:00,149,26,46,1,222,heavy,9,2,0
2021-09-01 09:15:00,77,13,7,23,120,normal,9,2,0
2021-09-01 09:30:00,37,16,13,29,95,normal,9,2,0
2021-09-01 09:45:00,79,8,16,12,115,normal,9,2,0
2021-09-01 10:00:00,97,2,16,7,122,normal,10,2,0
2021-09-01 10:15:00,22,8,31,8,69,normal,10,2,0
2021-09-01 10:30:00,31,23,19,12,85,normal,10,2,0
2021-09-01 10:45:00,49,22,16,5,92,normal,10,2,0
2021-09-01 11:00:00,32,5,3,21,61,normal,11,2,0
2021-09-01 11:15:00,40,6,11,28,85,normal,11,2,0
2021-09-01 11:30:00,42,6,10,21,79,normal,11,2,0
2021-09-01 11:45:00,37,9,7,25,78,normal,11,2,0
2021-09-01 12:00:00,45,5,5,24,79,normal,12,2,0
2021-09-01 12:15:00,64,10,4,28,106,normal,12,2,0
2021-09-01 12:30:00,33,8,6,23,70,normal,12,2,0
2021-09-01 12:45:00,34,6,12,27,79,normal,12,2,0
2021-09-01 13:00:00,40,9,5,20,74,normal,13,2,0
2021-09-01 13:15:00,64,19,22,12,117,normal,13,2,0
2021-09-01 13:30:00,108,24,34,7,173,heavy,13,2,0
2021-09-01 13:45:00,108,17,33,7,165,high,13,2,0
2021-09-01 14:00:00,50,23,21,11,105,normal,14,2,0
2021-09-01 14:15:00,16,21,10,16,63,low,14,2,0
2021-09-01 14:30:00,91,22,34,8,155,high,14,2,0
2021-09-01 14:45:00,89,19,37,18,163,high,14,2,0
2021-09-01 15:00:00,108,12,23,8,151,normal,15,2,0
2021-09-01 15:15:00,73,29,23,7,132,normal,15,2,0
2021-09-01 15:30:00,76,28,39,14,157,high,15,2,0
2021-09-01 15:45:00,19,15,20,17,71,normal,15,2,0
2021-09-01 16:00:00,102,37,48,9,196,heavy,16,2,0
2021-09-01 16:15:00,115,36,41,8,200,heavy,16,2,0
2021-09-01 16:30:00,142,23,23,6,194,heavy,16,2,0
2021-09-01 16:45:00,134,15,29,8,186,heavy,16,2,0
2021-09-01 17:00:00,146,18,49,9,222,heavy,17,2,0
2021-09-01 17:15:00,126,24,48,9,207,heavy,17,2,0
2021-09-01 17:30:00,138,18,27,6,189,heavy,17,2,0
2021-09-01 17:45:00,129,13,43,6,191,heavy,17,2,0
2021-09-01 18:00:00,127,35,23,10,195,heavy,18,2,0
2021-09-01 18:15:00,144,20,22,7,193,heavy,18,2,0
2021-09-01 18:30:00,117,19,31,7,174,heavy,18,2,0
2021-09-01 18:45:00,87,10,13,16,126,normal,18,2,0
2021-09-01 19:00:00,87,6,18,30,141,normal,19,2,0
2021-09-01 19:15:00,97,18,10,24,149,normal,19,2,0
2021-09-01 19:30:00,71,21,14,12,118,normal,19,2,0
2021-09-01 19:45:00,96,24,18,10,148,normal,19,2,0
2021-09-01 20:00:00,90,7,17,31,145,high,20,2,0
2021-09-01 20:15:00,74,6,12,34,126,high,20,2,0
2021-09-01 20:30:00,59,7,15,20,101,normal,20,2,0
2021-09-01 20:45:00,87,11,16,28,142,normal,20,2,0
2021-09-01 21:00:00,62,22,20,20,124,normal,21,2,0
2021-09-01 21:15:00,71,16,14,9,110,low,21,2,0
2021-09-01 21:30:00,98,9,15,18,140,normal,21,2,0
2021-09-01 21:45:00,93,8,10,16,127,normal,21,2,0
2021-09-01 22:00:00,17,4,0,36,57,normal,22,2,0
2021-09-01 22:15:00,16,1,1,29,47,normal,22,2,0
2021-09-01 22:30:00,15,2,0,10,27,low,22,2,0
2021-09-01 22:45:00,10,3,1,23,37,normal,22,2,0
2021-09-01 23:00:00,12,4,0,31,47,normal,23,2,0
2021-09-01 23:15:00,20,1,1,24,46,normal,23,2,0
2021-09-01 23:30:00,11,0,1,23,35,normal,23,2,0
2021-09-01 23:45:00,14,1,1,17,33,low,23,2,0
2021-09-02 00:00:00,12,5,1,38,56,normal,0,3,0
2021-09-02 00:15:00,15,4,1,29,49,normal,0,3,0
2021-09-02 00:30:00,12,4,0,40,56,normal,0,3,0
2021-09-02 00:45:00,11,5,0,22,38,normal,0,3,0
2021-09-02 01:00:00,14,5,1,21,41,normal,1,3,0
2021-09-02 01:15:00,14,3,0,39,56,normal,1,3,0
2021-09-02 01:30:00,10,4,1,11,26,low,1,3,0
2021-09-02 01:45:00,11,0,0,16,27,low,1,3,0
2021-09-02 02:00:00,12,3,0,39,54,normal,2,3,0
2021-09-02 02:15:00,11,0,1,36,48,normal,2,3,0
2021-09-02 02:30:00,16,2,0,35,53,normal,2,3,0
2021-09-02 02:45:00,17,3,1,36,57,normal,2,3,0
2021-09-02 03:00:00,13,1,1,13,28,low,3,3,0
2021-09-02 03:15:00,14,5,0,19,38,normal,3,3,0
2021-09-02 03:30:00,17,5,1,15,38,low,3,3,0
2021-09-02 03:45:00,19,3,0,13,35,low,3,3,0
2021-09-02 04:00:00,19,3,1,12,35,low,4,3,0
2021-09-02 04:15:00,54,15,10,8,87,low,4,3,0
2021-09-02 04:30:00,107,0,1,2,110,low,4,3,0
2021-09-02 04:45:00,116,20,5,14,155,normal,4,3,0
2021-09-02 05:00:00,78,2,4,9,93,low,5,3,0
2021-09-02 05:15:00,111,22,0,12,145,normal,5,3,0
2021-09-02 05:30:00,85,27,7,17,136,normal,5,3,0
2021-09-02 05:45:00,95,5,9,20,129,normal,5,3,0
2021-09-02 06:00:00,143,33,27,1,204,heavy,6,3,0
2021-09-02 06:15:00,133,40,37,0,210,heavy,6,3,0
2021-09-02 06:30:00,123,37,34,4,198,heavy,6,3,0
2021-09-02 06:45:00,133,34,36,1,204,heavy,6,3,0
2021-09-02 07:00:00,101,20,42,4,167,normal,7,3,0
2021-09-02 07:15:00,145,10,37,0,192,heavy,7,3,0
2021-09-02 07:30:00,141,39,40,5,225,heavy,7,3,0
2021-09-02 07:45:00,134,12,22,2,170,heavy,7,3,0
2021-09-02 08:00:00,126,10,26,4,166,high,8,3,0
2021-09-02 08:15:00,136,22,31,0,189,heavy,8,3,0
2021-09-02 08:30:00,128,26,42,4,200,heavy,8,3,0
2021-09-02 08:45:00,106,12,28,4,150,high,8,3,0
2021-09-02 09:00:00,140,27,36,2,205,heavy,9,3,0
2021-09-02 09:15:00,40,20,37,28,125,high,9,3,0
2021-09-02 09:30:00,13,25,33,12,83,normal,9,3,0
2021-09-02 09:45:00,18,22,26,10,76,normal,9,3,0
2021-09-02 10:00:00,59,5,36,12,112,high,10,3,0
2021-09-02 10:15:00,48,9,30,14,101,normal,10,3,0
2021-09-02 10:30:00,77,23,14,20,134,normal,10,3,0
2021-09-02 10:45:00,17,13,13,27,70,normal,10,3,0
2021-09-02 11:00:00,36,5,14,25,80,normal,11,3,0
2021-09-02 11:15:00,60,10,3,28,101,normal,11,3,0
2021-09-02 11:30:00,34,5,4,29,72,normal,11,3,0
2021-09-02 11:45:00,63,5,6,20,94,normal,11,3,0
2021-09-02 12:00:00,48,10,13,23,94,normal,12,3,0
2021-09-02 12:15:00,44,5,5,21,75,normal,12,3,0
2021-09-02 12:30:00,62,5,14,23,104,normal,12,3,0
2021-09-02 12:45:00,38,8,15,27,88,normal,12,3,0
2021-09-02 13:00:00,26,6,9,29,70,normal,13,3,0
2021-09-02 13:15:00,78,23,16,13,130,normal,13,3,0
2021-09-02 13:30:00,116,21,22,17,176,heavy,13,3,0
2021-09-02 13:45:00,94,13,11,16,134,normal,13,3,0
2021-09-02 14:00:00,52,19,26,10,107,normal,14,3,0
2021-09-02 14:15:00,70,13,12,10,105,low,14,3,0
2021-09-02 14:30:00,34,17,21,14,86,normal,14,3,0
2021-09-02 14:45:00,16,18,40,6,80,normal,14,3,0
2021-09-02 15:00:00,24,20,15,17,76,low,15,3,0
2021-09-02 15:15:00,21,15,33,12,81,normal,15,3,0
2021-09-02 15:30:00,100,10,18,7,135,normal,15,3,0
2021-09-02 15:45:00,117,22,11,5,155,normal,15,3,0
2021-09-02 16:00:00,145,30,40,8,223,normal,16,3,0
2021-09-02 16:15:00,113,38,45,7,203,heavy,16,3,0
2021-09-02 16:30:00,110,31,37,7,185,heavy,16,3,0
2021-09-02 16:45:00,126,15,26,6,173,heavy,16,3,0
2021-09-02 17:00:00,100,15,29,7,151,high,17,3,0
2021-09-02 17:15:00,147,28,29,10,214,heavy,17,3,0
2021-09-02 17:30:00,146,22,50,10,228,heavy,17,3,0
2021-09-02 17:45:00,148,23,27,5,203,heavy,17,3,0
2021-09-02 18:00:00,149,17,41,9,216,heavy,18,3,0
2021-09-02 18:15:00,136,32,41,7,216,heavy,18,3,0
2021-09-02 18:30:00,101,22,33,9,165,high,18,3,0
2021-09-02 18:45:00,87,18,13,34,152,high,18,3,0
2021-09-02 19:00:00,50,21,14,9,94,low,19,3,0
2021-09-02 19:15:00,63,23,19,34,139,high,19,3,0
2021-09-02 19:30:00,73,9,11,5,98,low,19,3,0
2021-09-02 19:45:00,78,13,20,25,136,normal,19,3,0
2021-09-02 20:00:00,71,22,12,14,119,normal,20,3,0
2021-09-02 20:15:00,80,17,11,15,123,normal,20,3,0
2021-09-02 20:30:00,62,21,10,35,128,high,20,3,0
2021-09-02 20:45:00,100,17,16,33,166,high,20,3,0
2021-09-02 21:00:00,95,15,18,9,137,normal,21,3,0
2021-09-02 21:15:00,102,14,15,34,165,high,21,3,0
2021-09-02 21:30:00,68,12,15,32,127,high,21,3,0
2021-09-02 21:45:00,74,5,19,5,103,normal,21,3,0
2021-09-02 22:00:00,15,4,1,21,41,normal,22,3,0
2021-09-02 22:15:00,16,0,1,24,41,normal,22,3,0
2021-09-02 22:30:00,12,0,0,12,24,low,22,3,0
2021-09-02 22:45:00,12,5,0,23,40,normal,22,3,0
2021-09-02 23:00:00,15,2,1,14,32,low,23,3,0
2021-09-02 23:15:00,10,3,0,23,36,normal,23,3,0
2021-09-02 23:30:00,16,2,0,35,53,normal,23,3,0
2021-09-02 23:45:00,13,3,0,22,38,normal,23,3,0
2021-09-03 00:00:00,13,0,0,32,45,normal,0,4,0
2021-09-03 00:15:00,11,1,0,27,39,normal,0,4,0
2021-09-03 00:30:00,17,1,0,32,50,normal,0,4,0
2021-09-03 00:45:00,11,2,0,17,30,low,0,4,0
2021-09-03 01:00:00,14,1,1,11,27,low,1,4,0
2021-09-03 01:15:00,17,2,0,33,52,normal,1,4,0
2021-09-03 01:30:00,15,2,1,38,56,normal,1,4,0
2021-09-03 01:45:00,13,4,1,24,42,normal,1,4,0
2021-09-03 02:00:00,11,5,1,11,28,low,2,4,0
2021-09-03 02:15:00,12,3,0,22,37,normal,2,4,0
2021-09-03 02:30:00,15,1,0,26,42,normal,2,4,0
2021-09-03 02:45:00,13,0,1,34,48,normal,2,4,0
2021-09-03 03:00:00,17,5,0,15,37,low,3,4,0
2021-09-03 03:15:00,20,3,1,26,50,normal,3,4,0
2021-09-03 03:30:00,18,4,0,30,52,normal,3,4,0
2021-09-03 03:45:00,12,1,1,19,33,normal,3,4,0
2021-09-03 04:00:00,20,0,0,12,32,low,4,4,0
2021-09-03 04:15:00,29,10,0,12,51,low,4,4,0
2021-09-03 04:30:00,39,20,1,10,70,low,4,4,0
2021-09-03 04:45:00,76,9,7,13,105,low,4,4,0
2021-09-03 05:00:00,33,17,0,13,63,low,5,4,0
2021-09-03 05:15:00,64,14,1,12,91,low,5,4,0
2021-09-03 05:30:00,44,7,1,11,63,low,5,4,0
2021-09-03 05:45:00,53,8,4,15,80,low,5,4,0
2021-09-03 06:00:00,75,6,7,13,101,low,6,4,0
2021-09-03 06:15:00,60,11,4,10,85,low,6,4,0
2021-09-03 06:30:00,35,14,2,14,65,low,6,4,0
2021-09-03 06:45:00,75,20,6,15,116,normal,6,4,0
2021-09-03 07:00:00,27,10,2,12,51,low,7,4,0
2021-09-03 07:15:00,61,20,7,14,102,low,7,4,0
2021-09-03 07:30:00,72,20,5,15,112,normal,7,4,0
2021-09-03 07:45:00,43,18,6,14,81,low,7,4,0
2021-09-03 08:00:00,54,10,4,14,82,low,8,4,0
2021-09-03 08:15:00,30,12,1,14,57,low,8,4,0
2021-09-03 08:30:00,72,8,6,12,98,low,8,4,0
2021-09-03 08:45:00,55,17,7,15,94,low,8,4,0
2021-09-03 09:00:00,36,20,0,13,69,low,9,4,0
2021-09-03 09:15:00,168,55,10,0,233,heavy,9,4,0
2021-09-03 09:30:00,135,61,28,2,226,heavy,9,4,0
2021-09-03 09:45:00,168,68,27,2,265,heavy,9,4,0
2021-09-03 10:00:00,139,44,16,1,200,heavy,10,4,0
2021-09-03 10:15:00,156,63,12,3,234,heavy,10,4,0
2021-09-03 10:30:00,141,51,27,3,222,heavy,10,4,0
2021-09-03 10:45:00,144,44,16,3,207,heavy,10,4,0
2021-09-03 11:00:00,132,65,23,0,220,heavy,11,4,0
2021-09-03 11:15:00,180,48,17,2,247,heavy,11,4,0
2021-09-03 11:30:00,140,67,20,4,231,heavy,11,4,0
2021-09-03 11:45:00,163,62,12,0,237,heavy,11,4,0
2021-09-03 12:00:00,148,70,15,0,233,heavy,12,4,0
2021-09-03 12:15:00,134,47,22,3,206,heavy,12,4,0
2021-09-03 12:30:00,162,51,13,0,226,heavy,12,4,0
2021-09-03 12:45:00,136,49,15,1,201,heavy,12,4,0
2021-09-03 13:00:00,147,52,26,0,225,heavy,13,4,0
2021-09-03 13:15:00,174,54,25,1,254,heavy,13,4,0
2021-09-03 13:30:00,135,69,20,1,225,heavy,13,4,0
2021-09-03 13:45:00,142,55,21,1,219,heavy,13,4,0
2021-09-03 14:00:00,144,59,14,2,219,heavy,14,4,0
2021-09-03 14:15:00,180,49,17,0,246,heavy,14,4,0
2021-09-03 14:30:00,153,59,20,4,236,heavy,14,4,0
2021-09-03 14:45:00,139,43,27,3,212,heavy,14,4,0
2021-09-03 15:00:00,179,60,12,0,251,heavy,15,4,0
2021-09-03 15:15:00,76,21,6,1,104,low,15,4,0
2021-09-03 15:30:00,59,25,19,1,104,normal,15,4,0
2021-09-03 15:45:00,51,20,12,1,84,low,15,4,0
2021-09-03 16:00:00,78,24,19,2,123,normal,16,4,0
2021-09-03 16:15:00,50,24,11,0,85,low,16,4,0
2021-09-03 16:30:00,59,25,8,0,92,low,16,4,0
2021-09-03 16:45:00,90,21,0,0,111,low,16,4,0
2021-09-03 17:00:00,79,26,21,2,128,normal,17,4,0
2021-09-03 17:15:00,56,21,4,1,82,low,17,4,0
2021-09-03 17:30:00,70,25,11,2,108,low,17,4,0
2021-09-03 17:45:00,54,27,21,2,104,normal,17,4,0
2021-09-03 18:00:00,53,22,13,2,90,low,18,4,0
2021-09-03 18:15:00,59,27,5,2,93,low,18,4,0
2021-09-03 18:30:00,63,30,21,0,114,normal,18,4,0
2021-09-03 18:45:00,87,21,16,0,124,normal,18,4,0
2021-09-03 19:00:00,71,26,19,1,117,normal,19,4,0
2021-09-03 19:15:00,32,5,5,13,55,low,19,4,0
2021-09-03 19:30:00,36,6,7,2,51,low,19,4,0
2021-09-03 19:45:00,35,10,0,2,47,low,19,4,0
2021-09-03 20:00:00,40,10,5,10,65,low,20,4,0
2021-09-03 20:15:00,44,6,1,3,54,low,20,4,0
2021-09-03 20:30:00,40,6,1,3,50,low,20,4,0
2021-09-03 20:45:00,45,2,7,7,61,low,20,4,0
2021-09-03 21:00:00,44,2,6,5,57,low,21,4,0
2021-09-03 21:15:00,33,4,4,5,46,low,21,4,0
2021-09-03 21:30:00,22,5,3,13,43,low,21,4,0
2021-09-03 21:45:00,33,5,5,1,44,low,21,4,0
2021-09-03 22:00:00,10,0,0,29,39,normal,22,4,0
2021-09-03 22:15:00,19,3,1,35,58,normal,22,4,0
2021-09-03 22:30:00,10,4,0,30,44,normal,22,4,0
2021-09-03 22:45:00,12,3,1,25,41,normal,22,4,0
2021-09-03 23:00:00,12,1,0,40,53,normal,23,4,0
2021-09-03 23:15:00,20,2,0,19,41,normal,23,4,0
2021-09-03 23:30:00,18,4,1,11,34,low,23,4,0
2021-09-03 23:45:00,19,1,1,37,58,normal,23,4,0
2021-09-04 00:00:00,13,2,0,25,40,normal,0,5,0
2021-09-04 00:15:00,16,4,1,15,36,low,0,5,0
2021-09-04 00:30:00,10,4,1,16,31,low,0,5,0
2021-09-04 00:45:00,18,3,0,19,40,normal,0,5,0
2021-09-04 01:00:00,15,5,0,10,30,low,1,5,0
2021-09-04 01:15:00,14,2,1,22,39,normal,1,5,0
2021-09-04 01:30:00,15,0,0,15,30,low,1,5,0
2021-09-04 01:45:00,17,5,0,21,43,normal,1,5,0
2021-09-04 02:00:00,14,0,1,12,27,low,2,5,0
2021-09-04 02:15:00,10,1,0,11,22,low,2,5,0
2021-09-04 02:30:00,18,5,0,18,41,low,2,5,0
2021-09-04 02:45:00,12,4,0,11,27,low,2,5,0
2021-09-04 03:00:00,17,0,1,30,48,normal,3,5,0
2021-09-04 03:15:00,20,1,0,28,49,normal,3,5,0
2021-09-04 03:30:00,19,5,1,38,63,normal,3,5,0
2021-09-04 03:45:00,15,0,0,36,51,normal,3,5,0
2021-09-04 04:00:00,10,2,0,30,42,normal,4,5,0
2021-09-04 04:15:00,74,4,4,13,95,low,4,5,0
2021-09-04 04:30:00,96,29,6,17,148,normal,4,5,0
2021-09-04 04:45:00,109,16,6,12,143,normal,4,5,0
2021-09-04 05:00:00,113,6,9,10,138,normal,5,5,0
2021-09-04 05:15:00,90,24,8,20,142,normal,5,5,0
2021-09-04 05:30:00,106,19,10,17,152,normal,5,5,0
2021-09-04 05:45:00,96,7,6,4,113,normal,5,5,0
2021-09-04 06:00:00,102,21,42,3,168,heavy,6,5,0
2021-09-04 06:15:00,140,35,50,0,225,heavy,6,5,0
2021-09-04 06:30:00,105,33,29,4,171,heavy,6,5,0
2021-09-04 06:45:00,134,26,27,1,188,heavy,6,5,0
2021-09-04 07:00:00,123,35,45,1,204,heavy,7,5,0
2021-09-04 07:15:00,128,31,26,0,185,heavy,7,5,0
2021-09-04 07:30:00,105,32,43,0,180,heavy,7,5,0
2021-09-04 07:45:00,137,13,31,5,186,heavy,7,5,0
2021-09-04 08:00:00,148,37,46,2,233,heavy,8,5,0
2021-09-04 08:15:00,105,14,35,2,156,high,8,5,0
2021-09-04 08:30:00,148,17,42,5,212,heavy,8,5,0
2021-09-04 08:45:00,116,22,30,3,171,heavy,8,5,0
2021-09-04 09:00:00,143,28,46,1,218,heavy,9,5,0
2021-09-04 09:15:00,30,24,13,13,80,low,9,5,0
2021-09-04 09:30:00,74,23,35,10,142,high,9,5,0
2021-09-04 09:45:00,67,5,36,17,125,high,9,5,0
2021-09-04 10:00:00,59,11,33,25,128,high,10,5,0
2021-09-04 10:15:00,34,21,39,16,110,normal,10,5,0
2021-09-04 10:30:00,72,24,10,9,115,normal,10,5,0
2021-09-04 10:45:00,73,12,32,5,122,high,10,5,0
2021-09-04 11:00:00,26,8,8,24,66,normal,11,5,0
2021-09-04 11:15:00,47,5,7,28,87,normal,11,5,0
2021-09-04 11:30:00,33,10,6,29,78,normal,11,5,0
2021-09-04 11:45:00,39,8,13,20,80,normal,11,5,0
2021-09-04 12:00:00,36,5,14,22,77,normal,12,5,0
2021-09-04 12:15:00,53,9,15,25,102,normal,12,5,0
2021-09-04 12:30:00,37,9,10,30,86,normal,12,5,0
2021-09-04 12:45:00,54,8,4,27,93,normal,12,5,0
2021-09-04 13:00:00,20,8,15,26,69,normal,13,5,0
2021-09-04 13:15:00,47,29,28,9,113,high,13,5,0
2021-09-04 13:30:00,51,27,10,20,108,normal,13,5,0
2021-09-04 13:45:00,114,11,40,20,185,heavy,13,5,0
2021-09-04 14:00:00,73,13,19,9,114,normal,14,5,0
2021-09-04 14:15:00,28,19,27,5,79,normal,14,5,0
2021-09-04 14:30:00,105,20,20,11,156,normal,14,5,0
2021-09-04 14:45:00,68,24,15,14,121,normal,14,5,0
2021-09-04 15:00:00,112,16,30,11,169,heavy,15,5,0
2021-09-04 15:15:00,120,30,28,15,193,heavy,15,5,0
2021-09-04 15:30:00,38,27,12,18,95,low,15,5,0
2021-09-04 15:45:00,94,17,14,15,140,normal,15,5,0
2021-09-04 16:00:00,107,28,45,8,188,heavy,16,5,0
2021-09-04 16:15:00,100,16,49,7,172,heavy,16,5,0
2021-09-04 16:30:00,145,15,20,9,189,heavy,16,5,0
2021-09-04 16:45:00,133,17,22,8,180,heavy,16,5,0
2021-09-04 17:00:00,117,36,41,10,204,heavy,17,5,0
2021-09-04 17:15:00,113,26,26,8,173,heavy,17,5,0
2021-09-04 17:30:00,101,20,21,9,151,normal,17,5,0
2021-09-04 17:45:00,149,33,45,10,237,heavy,17,5,0
2021-09-04 18:00:00,134,35,26,7,202,heavy,18,5,0
2021-09-04 18:15:00,106,11,45,9,171,heavy,18,5,0
2021-09-04 18:30:00,121,37,34,6,198,heavy,18,5,0
2021-09-04 18:45:00,97,13,11,15,136,normal,18,5,0
2021-09-04 19:00:00,91,17,18,29,155,normal,19,5,0
2021-09-04 19:15:00,57,16,13,19,105,normal,19,5,0
2021-09-04 19:30:00,110,10,10,20,150,normal,19,5,0
2021-09-04 19:45:00,71,14,17,30,132,normal,19,5,0
2021-09-04 20:00:00,89,25,20,24,158,normal,20,5,0
2021-09-04 20:15:00,87,16,15,14,132,normal,20,5,0
2021-09-04 20:30:00,106,12,16,9,143,normal,20,5,0
2021-09-04 20:45:00,78,10,19,20,127,normal,20,5,0
2021-09-04 21:00:00,61,10,16,27,114,normal,21,5,0
2021-09-04 21:15:00,74,19,15,24,132,normal,21,5,0
2021-09-04 21:30:00,56,20,11,25,112,normal,21,5,0
2021-09-04 21:45:00,106,22,16,18,162,normal,21,5,0
2021-09-04 22:00:00,10,1,1,12,24,low,22,5,0
2021-09-04 22:15:00,12,4,1,33,50,normal,22,5,0
2021-09-04 22:30:00,16,4,0,16,36,low,22,5,0
2021-09-04 22:45:00,18,1,0,18,37,low,22,5,0
2021-09-04 23:00:00,19,2,0,36,57,normal,23,5,0
2021-09-04 23:15:00,18,4,1,35,58,normal,23,5,0
2021-09-04 23:30:00,17,0,0,31,48,normal,23,5,0
2021-09-04 23:45:00,18,1,0,16,35,low,23,5,0
2021-09-05 00:00:00,15,4,0,37,56,normal,0,6,1
2021-09-05 00:15:00,11,5,0,14,30,low,0,6,1
2021-09-05 00:30:00,11,5,0,22,38,normal,0,6,1
2021-09-05 00:45:00,12,2,1,37,52,normal,0,6,1
2021-09-05 01:00:00,18,1,1,34,54,normal,1,6,1
2021-09-05 01:15:00,19,1,0,11,31,low,1,6,1
2021-09-05 01:30:00,11,4,1,26,42,normal,1,6,1
2021-09-05 01:45:00,18,3,0,28,49,normal,1,6,1
2021-09-05 02:00:00,12,4,1,37,54,normal,2,6,1
2021-09-05 02:15:00,11,1,1,29,42,normal,2,6,1
2021-09-05 02:30:00,19,5,1,29,54,normal,2,6,1
2021-09-05 02:45:00,18,4,0,11,33,low,2,6,1
2021-09-05 03:00:00,16,4,0,29,49,normal,3,6,1
2021-09-05 03:15:00,19,4,1,33,57,normal,3,6,1
2021-09-05 03:30:00,15,3,1,12,31,low,3,6,1
2021-09-05 03:45:00,16,4,1,28,49,normal,3,6,1
2021-09-05 04:00:00,11,4,0,20,35,normal,4,6,1
2021-09-05 04:15:00,93,4,1,16,114,normal,4,6,1
2021-09-05 04:30:00,114,12,7,18,151,normal,4,6,1
2021-09-05 04:45:00,56,7,5,20,88,normal,4,6,1
2021-09-05 05:00:00,92,23,3,19,137,normal,5,6,1
2021-09-05 05:15:00,99,6,6,7,118,normal,5,6,1
2021-09-05 05:30:00,108,14,6,9,137,normal,5,6,1
2021-09-05 05:45:00,66,20,2,16,104,low,5,6,1
2021-09-05 06:00:00,147,26,44,5,222,heavy,6,6,1
2021-09-05 06:15:00,139,27,29,1,196,heavy,6,6,1
2021-09-05 06:30:00,119,31,36,5,191,heavy,6,6,1
2021-09-05 06:45:00,114,30,21,2,167,normal,6,6,1
2021-09-05 07:00:00,103,27,21,4,155,normal,7,6,1
2021-09-05 07:15:00,105,17,29,4,155,high,7,6,1
2021-09-05 07:30:00,124,29,41,1,195,heavy,7,6,1
2021-09-05 07:45:00,118,19,34,1,172,heavy,7,6,1
2021-09-05 08:00:00,101,37,32,0,170,heavy,8,6,1
2021-09-05 08:15:00,109,11,48,1,169,heavy,8,6,1
2021-09-05 08:30:00,143,12,23,3,181,heavy,8,6,1
2021-09-05 08:45:00,143,40,30,0,213,heavy,8,6,1
2021-09-05 09:00:00,128,16,34,0,178,heavy,9,6,1
2021-09-05 09:15:00,14,25,14,16,69,low,9,6,1
2021-09-05 09:30:00,99,10,11,15,135,normal,9,6,1
2021-09-05 09:45:00,67,1,22,14,104,normal,9,6,1
2021-09-05 10:00:00,42,2,29,9,82,normal,10,6,1
2021-09-05 10:15:00,92,3,33,21,149,high,10,6,1
2021-09-05 10:30:00,91,16,28,9,144,high,10,6,1
2021-09-05 10:45:00,25,9,10,28,72,normal,10,6,1
2021-09-05 11:00:00,37,5,12,29,83,normal,11,6,1
2021-09-05 11:15:00,55,6,12,29,102,normal,11,6,1
2021-09-05 11:30:00,49,8,8,26,91,normal,11,6,1
2021-09-05 11:45:00,69,9,3,20,101,normal,11,6,1
2021-09-05 12:00:00,38,6,6,24,74,normal,12,6,1
2021-09-05 12:15:00,40,8,12,21,81,normal,12,6,1
2021-09-05 12:30:00,53,5,3,20,81,normal,12,6,1
2021-09-05 12:45:00,21,8,4,28,61,normal,12,6,1
2021-09-05 13:00:00,24,7,4,20,55,normal,13,6,1
2021-09-05 13:15:00,47,24,24,9,104,normal,13,6,1
2021-09-05 13:30:00,90,30,32,8,160,high,13,6,1
2021-09-05 13:45:00,120,21,22,14,177,heavy,13,6,1
2021-09-05 14:00:00,120,12,40,13,185,heavy,14,6,1
2021-09-05 14:15:00,66,14,21,7,108,normal,14,6,1
2021-09-05 14:30:00,89,24,12,6,131,normal,14,6,1
2021-09-05 14:45:00,80,17,16,5,118,normal,14,6,1
2021-09-05 15:00:00,114,21,10,9,154,normal,15,6,1
2021-09-05 15:15:00,94,20,7,10,131,normal,15,6,1
2021-09-05 15:30:00,70,18,28,5,121,high,15,6,1
2021-09-05 15:45:00,56,17,15,8,96,low,15,6,1
2021-09-05 16:00:00,141,15,20,6,182,heavy,16,6,1
2021-09-05 16:15:00,150,19,46,7,222,heavy,16,6,1
2021-09-05 16:30:00,119,37,22,8,186,heavy,16,6,1
2021-09-05 16:45:00,144,14,44,5,207,heavy,16,6,1
2021-09-05 17:00:00,110,25,46,6,187,heavy,17,6,1
2021-09-05 17:15:00,138,15,31,10,194,heavy,17,6,1
2021-09-05 17:30:00,140,35,41,5,221,heavy,17,6,1
2021-09-05 17:45:00,103,24,28,8,163,high,17,6,1
2021-09-05 18:00:00,142,27,30,5,204,heavy,18,6,1
2021-09-05 18:15:00,149,13,22,9,193,heavy,18,6,1
2021-09-05 18:30:00,126,40,39,8,213,heavy,18,6,1
2021-09-05 18:45:00,78,15,14,28,135,normal,18,6,1
2021-09-05 19:00:00,102,15,11,29,157,normal,19,6,1
2021-09-05 19:15:00,96,22,20,12,150,normal,19,6,1
2021-09-05 19:30:00,110,24,15,14,163,normal,19,6,1
2021-09-05 19:45:00,97,22,17,13,149,normal,19,6,1
2021-09-05 20:00:00,53,19,11,18,101,low,20,6,1
2021-09-05 20:15:00,82,8,17,29,136,normal,20,6,1
2021-09-05 20:30:00,91,24,18,29,162,normal,20,6,1
2021-09-05 20:45:00,102,6,14,35,157,high,20,6,1
2021-09-05 21:00:00,109,6,15,18,148,normal,21,6,1
2021-09-05 21:15:00,78,16,13,27,134,normal,21,6,1
2021-09-05 21:30:00,66,12,16,33,127,high,21,6,1
2021-09-05 21:45:00,100,17,15,22,154,normal,21,6,1
2021-09-05 22:00:00,15,1,1,25,42,normal,22,6,1
2021-09-05 22:15:00,16,1,0,33,50,normal,22,6,1
2021-09-05 22:30:00,19,4,0,26,49,normal,22,6,1
2021-09-05 22:45:00,10,0,1,34,45,normal,22,6,1
2021-09-05 23:00:00,14,0,0,28,42,normal,23,6,1
2021-09-05 23:15:00,13,2,0,22,37,normal,23,6,1
2021-09-05 23:30:00,18,5,1,20,44,normal,23,6,1
2021-09-05 23:45:00,18,4,0,18,40,low,23,6,1
2021-09-06 00:00:00,11,3,0,26,40,normal,0,0,0
2021-09-06 00:15:00,13,1,0,24,38,normal,0,0,0
2021-09-06 00:30:00,19,5,1,15,40,low,0,0,0
2021-09-06 00:45:00,11,3,1,28,43,normal,0,0,0
2021-09-06 01:00:00,11,1,1,40,53,normal,1,0,0
2021-09-06 01:15:00,18,4,1,28,51,normal,1,0,0
2021-09-06 01:30:00,15,2,1,16,34,low,1,0,0
2021-09-06 01:45:00,20,0,0,27,47,normal,1,0,0
2021-09-06 02:00:00,14,5,0,17,36,low,2,0,0
2021-09-06 02:15:00,11,3,1,10,25,low,2,0,0
2021-09-06 02:30:00,18,5,0,22,45,normal,2,0,0
2021-09-06 02:45:00,12,4,0,16,32,low,2,0,0
2021-09-06 03:00:00,10,2,0,24,36,normal,3,0,0
2021-09-06 03:15:00,20,0,1,36,57,normal,3,0,0
2021-09-06 03:30:00,20,1,0,29,50,normal,3,0,0
2021-09-06 03:45:00,16,4,0,24,44,normal,3,0,0
2021-09-06 04:00:00,18,3,0,22,43,normal,4,0,0
2021-09-06 04:15:00,88,11,10,3,112,normal,4,0,0
2021-09-06 04:30:00,114,5,9,7,135,normal,4,0,0
2021-09-06 04:45:00,103,3,9,17,132,normal,4,0,0
2021-09-06 05:00:00,81,16,7,14,118,normal,5,0,0
2021-09-06 05:15:00,94,1,9,3,107,low,5,0,0
2021-09-06 05:30:00,56,11,9,15,91,low,5,0,0
2021-09-06 05:45:00,80,16,5,10,111,low,5,0,0
2021-09-06 06:00:00,138,35,47,4,224,heavy,6,0,0
2021-09-06 06:15:00,123,27,22,4,176,heavy,6,0,0
2021-09-06 06:30:00,114,30,36,2,182,heavy,6,0,0
2021-09-06 06:45:00,122,30,37,2,191,heavy,6,0,0
2021-09-06 07:00:00,148,10,28,2,188,heavy,7,0,0
2021-09-06 07:15:00,127,38,48,0,213,heavy,7,0,0
2021-09-06 07:30:00,113,32,44,1,190,heavy,7,0,0
2021-09-06 07:45:00,131,26,40,1,198,heavy,7,0,0
2021-09-06 08:00:00,108,27,44,5,184,heavy,8,0,0
2021-09-06 08:15:00,109,19,49,3,180,heavy,8,0,0
2021-09-06 08:30:00,125,15,28,3,171,heavy,8,0,0
2021-09-06 08:45:00,139,30,35,4,208,heavy,8,0,0
2021-09-06 09:00:00,103,35,50,2,190,heavy,9,0,0
2021-09-06 09:15:00,64,13,40,12,129,high,9,0,0
2021-09-06 09:30:00,79,1,10,30,120,normal,9,0,0
2021-09-06 09:45:00,50,2,7,14,73,low,9,0,0
2021-09-06 10:00:00,84,18,18,28,148,normal,10,0,0
2021-09-06 10:15:00,99,16,39,26,180,heavy,10,0,0
2021-09-06 10:30:00,42,3,27,18,90,normal,10,0,0
2021-09-06 10:45:00,53,2,29,24,108,normal,10,0,0
2021-09-06 11:00:00,63,10,8,28,109,normal,11,0,0
2021-09-06 11:15:00,24,8,3,20,55,normal,11,0,0
2021-09-06 11:30:00,46,8,6,26,86,normal,11,0,0
2021-09-06 11:45:00,20,7,8,26,61,normal,11,0,0
2021-09-06 12:00:00,41,8,7,27,83,normal,12,0,0
2021-09-06 12:15:00,44,5,3,28,80,normal,12,0,0
2021-09-06 12:30:00,33,6,14,28,81,normal,12,0,0
2021-09-06 12:45:00,30,9,7,25,71,normal,12,0,0
2021-09-06 13:00:00,68,7,5,25,105,normal,13,0,0
2021-09-06 13:15:00,28,29,26,5,88,normal,13,0,0
2021-09-06 13:30:00,96,20,14,18,148,normal,13,0,0
2021-09-06 13:45:00,24,15,26,13,78,normal,13,0,0
2021-09-06 14:00:00,70,21,32,18,141,high,14,0,0
2021-09-06 14:15:00,49,21,11,20,101,normal,14,0,0
2021-09-06 14:30:00,51,22,12,16,101,low,14,0,0
2021-09-06 14:45:00,84,12,15,15,126,normal,14,0,0
2021-09-06 15:00:00,99,18,7,20,144,normal,15,0,0
2021-09-06 15:15:00,106,10,9,8,133,normal,15,0,0
2021-09-06 15:30:00,6,11,34,20,71,normal,15,0,0
2021-09-06 15:45:00,59,29,15,16,119,normal,15,0,0
2021-09-06 16:00:00,139,25,41,5,210,heavy,16,0,0
2021-09-06 16:15:00,109,12,49,6,176,heavy,16,0,0
2021-09-06 16:30:00,124,24,47,9,204,heavy,16,0,0
2021-09-06 16:45:00,135,29,39,7,210,heavy,16,0,0
2021-09-06 17:00:00,137,15,37,7,196,heavy,17,0,0
2021-09-06 17:15:00,119,28,46,9,202,heavy,17,0,0
2021-09-06 17:30:00,127,21,28,5,181,heavy,17,0,0
2021-09-06 17:45:00,109,37,44,9,199,heavy,17,0,0
2021-09-06 18:00:00,145,27,35,7,214,heavy,18,0,0
2021-09-06 18:15:00,133,36,28,6,203,heavy,18,0,0
2021-09-06 18:30:00,138,19,36,5,198,heavy,18,0,0
2021-09-06 18:45:00,73,5,20,10,108,normal,18,0,0
2021-09-06 19:00:00,83,11,14,33,141,high,19,0,0
2021-09-06 19:15:00,89,8,10,19,126,normal,19,0,0
2021-09-06 19:30:00,99,19,18,24,160,normal,19,0,0
2021-09-06 19:45:00,54,17,14,8,93,low,19,0,0
2021-09-06 20:00:00,58,18,14,6,96,low,20,0,0
2021-09-06 20:15:00,56,16,12,9,93,low,20,0,0
2021-09-06 20:30:00,77,6,20,5,108,normal,20,0,0
2021-09-06 20:45:00,85,6,18,17,126,normal,20,0,0
2021-09-06 21:00:00,105,14,13,32,164,high,21,0,0
2021-09-06 21:15:00,96,21,11,24,152,normal,21,0,0
2021-09-06 21:30:00,66,22,17,16,121,normal,21,0,0
2021-09-06 21:45:00,88,15,19,14,136,normal,21,0,0
2021-09-06 22:00:00,16,1,1,24,42,normal,22,0,0
2021-09-06 22:15:00,13,1,0,11,25,low,22,0,0
2021-09-06 22:30:00,13,5,1,23,42,normal,22,0,0
2021-09-06 22:45:00,19,5,0,37,61,normal,22,0,0
2021-09-06 23:00:00,19,1,0,31,51,normal,23,0,0
2021-09-06 23:15:00,11,5,0,19,35,normal,23,0,0
2021-09-06 23:30:00,18,3,0,32,53,normal,23,0,0
2021-09-06 23:45:00,17,1,1,38,57,normal,23,0,0
2021-09-07 00:00:00,17,3,0,20,40,normal,0,1,0
2021-09-07 00:15:00,18,4,1,19,42,normal,0,1,0
2021-09-07 00:30:00,19,3,0,24,46,normal,0,1,0
2021-09-07 00:45:00,16,3,0,15,34,low,0,1,0
2021-09-07 01:00:00,12,5,1,21,39,normal,1,1,0
2021-09-07 01:15:00,17,3,0,36,56,normal,1,1,0
2021-09-07 01:30:00,19,4,1,21,45,normal,1,1,0
2021-09-07 01:45:00,13,5,0,20,38,normal,1,1,0
2021-09-07 02:00:00,14,0,1,37,52,normal,2,1,0
2021-09-07 02:15:00,14,5,0,39,58,normal,2,1,0
2021-09-07 02:30:00,13,1,0,19,33,normal,2,1,0
2021-09-07 02:45:00,18,5,1,25,49,normal,2,1,0
2021-09-07 03:00:00,15,1,1,15,32,low,3,1,0
2021-09-07 03:15:00,19,2,0,30,51,normal,3,1,0
2021-09-07 03:30:00,18,2,1,27,48,normal,3,1,0
2021-09-07 03:45:00,13,1,0,38,52,normal,3,1,0
2021-09-07 04:00:00,19,2,0,32,53,normal,4,1,0
2021-09-07 04:15:00,116,0,1,9,126,normal,4,1,0
2021-09-07 04:30:00,60,12,8,15,95,low,4,1,0
2021-09-07 04:45:00,82,15,0,19,116,normal,4,1,0
2021-09-07 05:00:00,67,23,7,3,100,low,5,1,0
2021-09-07 05:15:00,59,27,10,18,114,normal,5,1,0
2021-09-07 05:30:00,66,6,9,5,86,low,5,1,0
2021-09-07 05:45:00,120,10,3,16,149,normal,5,1,0
2021-09-07 06:00:00,121,22,30,0,173,heavy,6,1,0
2021-09-07 06:15:00,130,27,39,5,201,heavy,6,1,0
2021-09-07 06:30:00,139,31,44,3,217,heavy,6,1,0
2021-09-07 06:45:00,129,14,43,5,191,heavy,6,1,0
2021-09-07 07:00:00,131,28,43,5,207,heavy,7,1,0
2021-09-07 07:15:00,119,39,24,1,183,heavy,7,1,0
2021-09-07 07:30:00,142,25,34,5,206,heavy,7,1,0
2021-09-07 07:45:00,123,22,22,3,170,heavy,7,1,0
2021-09-07 08:00:00,106,19,38,4,167,normal,8,1,0
2021-09-07 08:15:00,115,39,20,2,176,heavy,8,1,0
2021-09-07 08:30:00,111,17,32,1,161,high,8,1,0
2021-09-07 08:45:00,144,26,50,3,223,normal,8,1,0
2021-09-07 09:00:00,126,31,48,2,207,heavy,9,1,0
2021-09-07 09:15:00,73,22,21,29,145,normal,9,1,0
2021-09-07 09:30:00,28,7,25,18,78,normal,9,1,0
2021-09-07 09:45:00,31,10,40,9,90,normal,9,1,0
2021-09-07 10:00:00,51,14,33,14,112,high,10,1,0
2021-09-07 10:15:00,22,7,39,23,91,normal,10,1,0
2021-09-07 10:30:00,46,5,11,21,83,normal,10,1,0
2021-09-07 10:45:00,72,22,21,27,142,normal,10,1,0
2021-09-07 11:00:00,70,5,5,29,109,normal,11,1,0
2021-09-07 11:15:00,28,9,9,24,70,normal,11,1,0
2021-09-07 11:30:00,44,5,11,23,83,normal,11,1,0
2021-09-07 11:45:00,27,6,13,30,76,normal,11,1,0
2021-09-07 12:00:00,20,6,6,23,55,normal,12,1,0
2021-09-07 12:15:00,29,7,3,28,67,normal,12,1,0
2021-09-07 12:30:00,20,6,5,27,58,normal,12,1,0
2021-09-07 12:45:00,65,9,15,22,111,normal,12,1,0
2021-09-07 13:00:00,36,5,6,20,67,normal,13,1,0
2021-09-07 13:15:00,99,21,21,6,147,normal,13,1,0
2021-09-07 13:30:00,101,21,34,18,174,heavy,13,1,0
2021-09-07 13:45:00,98,29,34,12,173,heavy,13,1,0
2021-09-07 14:00:00,113,20,7,13,153,normal,14,1,0
2021-09-07 14:15:00,75,24,27,7,133,high,14,1,0
2021-09-07 14:30:00,71,21,38,11,141,high,14,1,0
2021-09-07 14:45:00,119,13,32,7,171,heavy,14,1,0
2021-09-07 15:00:00,114,11,39,13,177,heavy,15,1,0
2021-09-07 15:15:00,99,26,8,11,144,normal,15,1,0
2021-09-07 15:30:00,39,12,21,9,81,normal,15,1,0
2021-09-07 15:45:00,114,26,16,20,176,heavy,15,1,0
2021-09-07 16:00:00,120,32,39,9,200,heavy,16,1,0
2021-09-07 16:15:00,143,24,35,6,208,heavy,16,1,0
2021-09-07 16:30:00,121,28,21,5,175,heavy,16,1,0
2021-09-07 16:45:00,134,23,28,10,195,heavy,16,1,0
2021-09-07 17:00:00,103,13,37,10,163,high,17,1,0
2021-09-07 17:15:00,122,12,48,10,192,heavy,17,1,0
2021-09-07 17:30:00,145,39,23,6,213,heavy,17,1,0
2021-09-07 17:45:00,105,13,48,10,176,heavy,17,1,0
2021-09-07 18:00:00,144,13,40,10,207,heavy,18,1,0
2021-09-07 18:15:00,103,18,40,5,166,high,18,1,0
2021-09-07 18:30:00,120,15,34,8,177,heavy,18,1,0
2021-09-07 18:45:00,56,19,16,13,104,normal,18,1,0
2021-09-07 19:00:00,56,5,17,14,92,normal,19,1,0
2021-09-07 19:15:00,108,15,13,5,141,normal,19,1,0
2021-09-07 19:30:00,58,23,14,34,129,high,19,1,0
2021-09-07 19:45:00,58,13,11,33,115,high,19,1,0
2021-09-07 20:00:00,76,24,14,15,129,normal,20,1,0
2021-09-07 20:15:00,69,8,13,28,118,normal,20,1,0
2021-09-07 20:30:00,54,9,12,10,85,low,20,1,0
2021-09-07 20:45:00,89,7,10,10,116,normal,20,1,0
2021-09-07 21:00:00,110,18,18,10,156,normal,21,1,0
2021-09-07 21:15:00,86,12,17,18,133,normal,21,1,0
2021-09-07 21:30:00,82,7,16,9,114,normal,21,1,0
2021-09-07 21:45:00,102,5,19,11,137,normal,21,1,0
2021-09-07 22:00:00,16,5,0,21,42,normal,22,1,0
2021-09-07 22:15:00,11,3,1,39,54,normal,22,1,0
2021-09-07 22:30:00,18,5,0,11,34,low,22,1,0
2021-09-07 22:45:00,12,0,1,32,45,normal,22,1,0
2021-09-07 23:00:00,15,4,1,39,59,normal,23,1,0
2021-09-07 23:15:00,15,4,0,26,45,normal,23,1,0
2021-09-07 23:30:00,13,1,0,30,44,normal,23,1,0
2021-09-07 23:45:00,12,3,0,28,43,normal,23,1,0
2021-09-08 00:00:00,17,2,1,20,40,normal,0,2,0
2021-09-08 00:15:00,14,5,1,33,53,normal,0,2,0
2021-09-08 00:30:00,16,3,1,11,31,low,0,2,0
2021-09-08 00:45:00,18,2,1,13,34,low,0,2,0
2021-09-08 01:00:00,12,2,1,17,32,low,1,2,0
2021-09-08 01:15:00,17,4,1,15,37,low,1,2,0
2021-09-08 01:30:00,18,1,1,25,45,normal,1,2,0
2021-09-08 01:45:00,20,1,1,10,32,low,1,2,0
2021-09-08 02:00:00,15,1,0,21,37,normal,2,2,0
2021-09-08 02:15:00,11,3,1,34,49,normal,2,2,0
2021-09-08 02:30:00,19,0,1,13,33,low,2,2,0
2021-09-08 02:45:00,10,3,0,14,27,low,2,2,0
2021-09-08 03:00:00,17,5,1,17,40,low,3,2,0
2021-09-08 03:15:00,16,1,0,11,28,low,3,2,0
2021-09-08 03:30:00,11,0,1,33,45,normal,3,2,0
2021-09-08 03:45:00,10,5,0,39,54,normal,3,2,0
2021-09-08 04:00:00,12,3,0,32,47,normal,4,2,0
2021-09-08 04:15:00,106,16,10,10,142,normal,4,2,0
2021-09-08 04:30:00,69,18,0,12,99,low,4,2,0
2021-09-08 04:45:00,103,26,6,12,147,normal,4,2,0
2021-09-08 05:00:00,99,25,6,6,136,normal,5,2,0
2021-09-08 05:15:00,85,9,4,11,109,low,5,2,0
2021-09-08 05:30:00,109,0,3,8,120,normal,5,2,0
2021-09-08 05:45:00,106,27,1,6,140,normal,5,2,0
2021-09-08 06:00:00,133,28,31,3,195,heavy,6,2,0
2021-09-08 06:15:00,108,39,34,5,186,heavy,6,2,0
2021-09-08 06:30:00,101,12,48,1,162,high,6,2,0
2021-09-08 06:45:00,145,11,29,1,186,heavy,6,2,0
2021-09-08 07:00:00,112,33,29,3,177,heavy,7,2,0
2021-09-08 07:15:00,111,18,32,4,165,high,7,2,0
2021-09-08 07:30:00,133,39,44,2,218,heavy,7,2,0
2021-09-08 07:45:00,115,34,37,5,191,heavy,7,2,0
2021-09-08 08:00:00,135,35,38,3,211,heavy,8,2,0
2021-09-08 08:15:00,142,40,28,3,213,heavy,8,2,0
2021-09-08 08:30:00,124,11,27,2,164,high,8,2,0
2021-09-08 08:45:00,122,29,31,5,187,heavy,8,2,0
2021-09-08 09:00:00,101,19,23,5,148,normal,9,2,0
2021-09-08 09:15:00,72,5,15,20,112,normal,9,2,0
2021-09-08 09:30:00,100,13,23,9,145,normal,9,2,0
2021-09-08 09:45:00,32,10,33,8,83,normal,9,2,0
2021-09-08 10:00:00,42,25,37,12,116,high,10,2,0
2021-09-08 10:15:00,81,25,40,20,166,high,10,2,0
2021-09-08 10:30:00,56,18,9,23,106,normal,10,2,0
2021-09-08 10:45:00,84,9,31,17,141,high,10,2,0
2021-09-08 11:00:00,36,9,8,28,81,normal,11,2,0
2021-09-08 11:15:00,32,5,11,27,75,normal,11,2,0
2021-09-08 11:30:00,26,7,15,27,75,normal,11,2,0
2021-09-08 11:45:00,34,5,5,22,66,normal,11,2,0
2021-09-08 12:00:00,66,9,6,30,111,normal,12,2,0
2021-09-08 12:15:00,69,10,4,24,107,normal,12,2,0
2021-09-08 12:30:00,44,7,9,20,80,normal,12,2,0
2021-09-08 12:45:00,58,10,5,27,100,normal,12,2,0
2021-09-08 13:00:00,27,6,14,30,77,normal,13,2,0
2021-09-08 13:15:00,19,21,25,15,80,normal,13,2,0
2021-09-08 13:30:00,39,15,30,8,92,normal,13,2,0
2021-09-08 13:45:00,109,21,10,12,152,normal,13,2,0
2021-09-08 14:00:00,93,10,9,15,127,normal,14,2,0
2021-09-08 14:15:00,73,16,12,11,112,normal,14,2,0
2021-09-08 14:30:00,111,18,29,16,174,heavy,14,2,0
2021-09-08 14:45:00,37,20,10,19,86,normal,14,2,0
2021-09-08 15:00:00,74,23,13,20,130,normal,15,2,0
2021-09-08 15:15:00,32,28,35,6,101,normal,15,2,0
2021-09-08 15:30:00,34,23,19,17,93,normal,15,2,0
2021-09-08 15:45:00,59,25,9,20,113,normal,15,2,0
2021-09-08 16:00:00,145,12,24,8,189,heavy,16,2,0
2021-09-08 16:15:00,118,17,28,8,171,heavy,16,2,0
2021-09-08 16:30:00,145,20,47,8,220,heavy,16,2,0
2021-09-08 16:45:00,140,25,46,10,221,heavy,16,2,0
2021-09-08 17:00:00,120,35,43,7,205,heavy,17,2,0
2021-09-08 17:15:00,126,24,31,7,188,heavy,17,2,0
2021-09-08 17:30:00,106,22,43,5,176,heavy,17,2,0
2021-09-08 17:45:00,137,40,28,9,214,heavy,17,2,0
2021-09-08 18:00:00,108,40,25,6,179,heavy,18,2,0
2021-09-08 18:15:00,135,15,50,6,206,heavy,18,2,0
2021-09-08 18:30:00,121,21,49,8,199,heavy,18,2,0
2021-09-08 18:45:00,59,6,20,6,91,normal,18,2,0
2021-09-08 19:00:00,59,13,18,27,117,normal,19,2,0
2021-09-08 19:15:00,103,7,15,15,140,normal,19,2,0
2021-09-08 19:30:00,56,14,14,31,115,high,19,2,0
2021-09-08 19:45:00,106,23,12,9,150,normal,19,2,0
2021-09-08 20:00:00,109,5,16,17,147,normal,20,2,0
2021-09-08 20:15:00,110,5,20,11,146,normal,20,2,0
2021-09-08 20:30:00,86,15,15,23,139,normal,20,2,0
2021-09-08 20:45:00,91,18,19,26,154,normal,20,2,0
2021-09-08 21:00:00,99,19,15,28,161,normal,21,2,0
2021-09-08 21:15:00,93,14,20,17,144,normal,21,2,0
2021-09-08 21:30:00,89,25,13,23,150,normal,21,2,0
2021-09-08 21:45:00,107,15,12,24,158,normal,21,2,0
2021-09-08 22:00:00,16,5,0,14,35,low,22,2,0
2021-09-08 22:15:00,14,5,1,20,40,normal,22,2,0
2021-09-08 22:30:00,18,3,0,24,45,normal,22,2,0
2021-09-08 22:45:00,12,3,0,40,55,normal,22,2,0
2021-09-08 23:00:00,14,4,1,27,46,normal,23,2,0
2021-09-08 23:15:00,18,5,1,15,39,low,23,2,0
2021-09-08 23:30:00,10,4,1,23,38,normal,23,2,0
2021-09-08 23:45:00,10,5,0,14,29,low,23,2,0
2021-09-09 00:00:00,14,3,0,28,45,normal,0,3,0
2021-09-09 00:15:00,10,2,0,38,50,normal,0,3,0
2021-09-09 00:30:00,19,0,0,32,51,normal,0,3,0
2021-09-09 00:45:00,20,3,0,19,42,normal,0,3,0
2021-09-09 01:00:00,18,3,0,14,35,low,1,3,0
2021-09-09 01:15:00,11,2,0,12,25,low,1,3,0
2021-09-09 01:30:00,17,1,1,13,32,low,1,3,0
2021-09-09 01:45:00,10,0,1,36,47,normal,1,3,0
2021-09-09 02:00:00,17,0,0,32,49,normal,2,3,0
2021-09-09 02:15:00,20,5,1,22,48,normal,2,3,0
2021-09-09 02:30:00,12,3,0,17,32,low,2,3,0
2021-09-09 02:45:00,13,0,0,31,44,normal,2,3,0
2021-09-09 03:00:00,11,1,1,35,48,normal,3,3,0
2021-09-09 03:15:00,18,2,0,19,39,normal,3,3,0
2021-09-09 03:30:00,15,0,1,24,40,normal,3,3,0
2021-09-09 03:45:00,14,3,0,25,42,normal,3,3,0
2021-09-09 04:00:00,12,0,1,16,29,low,4,3,0
2021-09-09 04:15:00,85,24,5,5,119,normal,4,3,0
2021-09-09 04:30:00,71,22,5,2,100,low,4,3,0
2021-09-09 04:45:00,108,4,5,3,120,normal,4,3,0
2021-09-09 05:00:00,63,29,5,15,112,normal,5,3,0
2021-09-09 05:15:00,62,12,3,18,95,low,5,3,0
2021-09-09 05:30:00,118,15,3,11,147,normal,5,3,0
2021-09-09 05:45:00,90,21,2,14,127,normal,5,3,0
2021-09-09 06:00:00,141,30,31,1,203,heavy,6,3,0
2021-09-09 06:15:00,126,31,33,2,192,heavy,6,3,0
2021-09-09 06:30:00,112,26,30,4,172,heavy,6,3,0
2021-09-09 06:45:00,112,12,38,4,166,high,6,3,0
2021-09-09 07:00:00,144,14,33,4,195,heavy,7,3,0
2021-09-09 07:15:00,127,13,36,1,177,heavy,7,3,0
2021-09-09 07:30:00,146,10,44,5,205,heavy,7,3,0
2021-09-09 07:45:00,146,22,26,4,198,heavy,7,3,0
2021-09-09 08:00:00,101,10,48,5,164,high,8,3,0
2021-09-09 08:15:00,104,19,24,4,151,normal,8,3,0
2021-09-09 08:30:00,150,20,43,0,213,heavy,8,3,0
2021-09-09 08:45:00,110,35,45,2,192,heavy,8,3,0
2021-09-09 09:00:00,139,15,28,2,184,heavy,9,3,0
2021-09-09 09:15:00,99,17,32,7,155,high,9,3,0
2021-09-09 09:30:00,22,15,7,19,63,normal,9,3,0
2021-09-09 09:45:00,11,12,21,24,68,normal,9,3,0
2021-09-09 10:00:00,47,20,18,16,101,normal,10,3,0
2021-09-09 10:15:00,54,1,35,26,116,high,10,3,0
2021-09-09 10:30:00,26,16,13,16,71,low,10,3,0
2021-09-09 10:45:00,99,18,39,19,175,heavy,10,3,0
2021-09-09 11:00:00,31,9,11,28,79,normal,11,3,0
2021-09-09 11:15:00,24,8,13,23,68,normal,11,3,0
2021-09-09 11:30:00,21,7,9,20,57,normal,11,3,0
2021-09-09 11:45:00,60,10,5,25,100,normal,11,3,0
2021-09-09 12:00:00,29,9,12,21,71,normal,12,3,0
2021-09-09 12:15:00,37,7,14,28,86,normal,12,3,0
2021-09-09 12:30:00,53,7,11,22,93,normal,12,3,0
2021-09-09 12:45:00,35,5,15,25,80,normal,12,3,0
2021-09-09 13:00:00,53,6,10,28,97,normal,13,3,0
2021-09-09 13:15:00,114,18,17,8,157,normal,13,3,0
2021-09-09 13:30:00,95,28,22,9,154,normal,13,3,0
2021-09-09 13:45:00,62,23,38,19,142,high,13,3,0
2021-09-09 14:00:00,70,28,12,12,122,normal,14,3,0
2021-09-09 14:15:00,35,20,10,8,73,low,14,3,0
2021-09-09 14:30:00,60,23,10,20,113,normal,14,3,0
2021-09-09 14:45:00,40,22,25,9,96,normal,14,3,0
2021-09-09 15:00:00,53,21,6,11,91,low,15,3,0
2021-09-09 15:15:00,99,16,38,7,160,high,15,3,0
2021-09-09 15:30:00,86,21,31,18,156,high,15,3,0
2021-09-09 15:45:00,79,28,35,13,155,high,15,3,0
2021-09-09 16:00:00,146,25,33,8,212,heavy,16,3,0
2021-09-09 16:15:00,116,24,36,6,182,heavy,16,3,0
2021-09-09 16:30:00,107,14,44,5,170,heavy,16,3,0
2021-09-09 16:45:00,115,20,27,9,171,heavy,16,3,0
2021-09-09 17:00:00,113,23,43,6,185,heavy,17,3,0
2021-09-09 17:15:00,102,20,31,5,158,high,17,3,0
2021-09-09 17:30:00,138,27,21,7,193,heavy,17,3,0
2021-09-09 17:45:00,146,13,38,9,206,heavy,17,3,0
2021-09-09 18:00:00,139,33,41,7,220,heavy,18,3,0
2021-09-09 18:15:00,130,24,48,9,211,heavy,18,3,0
2021-09-09 18:30:00,135,31,34,8,208,heavy,18,3,0
2021-09-09 18:45:00,106,22,16,20,164,normal,18,3,0
2021-09-09 19:00:00,109,23,14,26,172,heavy,19,3,0
2021-09-09 19:15:00,108,24,19,10,161,normal,19,3,0
2021-09-09 19:30:00,50,16,16,11,93,normal,19,3,0
2021-09-09 19:45:00,102,22,17,10,151,normal,19,3,0
2021-09-09 20:00:00,72,25,10,27,134,normal,20,3,0
2021-09-09 20:15:00,91,13,18,13,135,normal,20,3,0
2021-09-09 20:30:00,67,19,11,8,105,low,20,3,0
2021-09-09 20:45:00,61,14,10,5,90,low,20,3,0
2021-09-09 21:00:00,107,13,14,28,162,normal,21,3,0
2021-09-09 21:15:00,91,5,12,34,142,high,21,3,0
2021-09-09 21:30:00,106,18,13,27,164,normal,21,3,0
2021-09-09 21:45:00,107,14,10,18,149,normal,21,3,0
2021-09-09 22:00:00,17,4,1,20,42,normal,22,3,0
2021-09-09 22:15:00,11,4,1,30,46,normal,22,3,0
2021-09-09 22:30:00,11,4,0,23,38,normal,22,3,0
2021-09-09 22:45:00,16,3,1,36,56,normal,22,3,0
2021-09-09 23:00:00,11,0,1,30,42,normal,23,3,0
2021-09-09 23:15:00,15,4,1,25,45,normal,23,3,0
2021-09-09 23:30:00,16,5,0,27,48,normal,23,3,0
2021-09-09 23:45:00,14,3,1,15,33,low,23,3,0
